,ward,precinct,tot_votes,eman_votes,garcia_votes,eman_pct,garcia_pct
0,1,1,259,93,166,0.3590733590733591,0.640926640926641
1,1,2,254,75,179,0.2952755905511811,0.7047244094488189
2,1,3,269,149,120,0.5539033457249071,0.44609665427509293
3,1,4,277,145,132,0.5234657039711191,0.47653429602888087
4,1,5,217,144,73,0.663594470046083,0.33640552995391704
5,1,6,290,144,146,0.496551724137931,0.503448275862069
6,1,7,186,79,107,0.42473118279569894,0.5752688172043011
7,1,8,269,158,111,0.587360594795539,0.41263940520446096
8,1,9,264,106,158,0.4015151515151515,0.5984848484848485
9,1,10,226,138,88,0.6106194690265486,0.3893805309734513
10,1,11,253,149,104,0.5889328063241107,0.41106719367588934
11,1,12,300,139,161,0.4633333333333333,0.5366666666666666
12,1,13,121,40,81,0.3305785123966942,0.6694214876033058
13,1,14,270,147,123,0.5444444444444444,0.45555555555555555
14,1,15,256,85,171,0.33203125,0.66796875
15,1,16,228,64,164,0.2807017543859649,0.7192982456140351
16,1,17,251,83,168,0.33067729083665337,0.6693227091633466
17,1,18,289,104,185,0.35986159169550175,0.6401384083044983
18,1,19,388,126,262,0.3247422680412371,0.6752577319587629
19,1,20,238,72,166,0.3025210084033613,0.6974789915966386
20,1,21,232,154,78,0.6637931034482759,0.33620689655172414
21,1,22,167,68,99,0.40718562874251496,0.592814371257485
22,1,23,395,155,240,0.3924050632911392,0.6075949367088608
23,1,24,200,55,145,0.275,0.725
24,1,25,201,77,124,0.38308457711442784,0.6169154228855721
25,1,26,198,39,159,0.19696969696969696,0.803030303030303
26,1,27,247,118,129,0.4777327935222672,0.5222672064777328
27,1,28,133,51,82,0.38345864661654133,0.6165413533834586
28,1,29,257,139,118,0.5408560311284046,0.4591439688715953
29,1,30,310,83,227,0.267741935483871,0.7322580645161291
30,1,31,279,123,156,0.44086021505376344,0.5591397849462365
31,1,32,264,138,126,0.5227272727272727,0.4772727272727273
32,1,33,282,140,142,0.49645390070921985,0.5035460992907801
33,1,34,235,86,149,0.3659574468085106,0.6340425531914894
34,1,35,299,145,154,0.48494983277591974,0.5150501672240803
35,1,36,232,150,82,0.646551724137931,0.35344827586206895
36,1,37,241,132,109,0.5477178423236515,0.45228215767634855
37,1,38,271,109,162,0.4022140221402214,0.5977859778597786
38,1,39,236,107,129,0.4533898305084746,0.5466101694915254
39,1,40,281,165,116,0.5871886120996441,0.4128113879003559
40,1,41,192,72,120,0.375,0.625
41,1,42,91,29,62,0.31868131868131866,0.6813186813186813
42,1,43,183,86,97,0.46994535519125685,0.5300546448087432
43,1,44,196,87,109,0.44387755102040816,0.5561224489795918
44,2,1,251,137,114,0.545816733067729,0.4541832669322709
45,2,2,344,299,45,0.8691860465116279,0.1308139534883721
46,2,3,276,176,100,0.6376811594202898,0.36231884057971014
47,2,4,268,141,127,0.5261194029850746,0.47388059701492535
48,2,5,313,168,145,0.536741214057508,0.46325878594249204
49,2,6,269,132,137,0.49070631970260226,0.5092936802973977
50,2,7,282,170,112,0.6028368794326241,0.3971631205673759
51,2,8,287,148,139,0.5156794425087108,0.4843205574912892
52,2,9,271,229,42,0.8450184501845018,0.15498154981549817
53,2,10,369,334,35,0.9051490514905149,0.0948509485094851
54,2,11,377,344,33,0.9124668435013262,0.08753315649867374
55,2,12,336,258,78,0.7678571428571429,0.23214285714285715
56,2,13,398,336,62,0.8442211055276382,0.15577889447236182
57,2,14,343,172,171,0.5014577259475219,0.49854227405247814
58,2,15,276,174,102,0.6304347826086957,0.3695652173913043
59,2,16,219,148,71,0.6757990867579908,0.3242009132420091
60,2,17,351,218,133,0.6210826210826211,0.3789173789173789
61,2,18,289,246,43,0.8512110726643599,0.14878892733564014
62,2,19,305,274,31,0.898360655737705,0.10163934426229508
63,2,20,271,234,37,0.8634686346863468,0.13653136531365315
64,2,21,315,186,129,0.5904761904761905,0.4095238095238095
65,2,22,379,319,60,0.841688654353562,0.158311345646438
66,2,23,337,310,27,0.9198813056379822,0.08011869436201781
67,2,24,296,252,44,0.8513513513513513,0.14864864864864866
68,2,25,268,186,82,0.6940298507462687,0.30597014925373134
69,2,26,246,190,56,0.7723577235772358,0.22764227642276422
70,2,27,299,256,43,0.8561872909698997,0.14381270903010032
71,2,28,344,273,71,0.7936046511627907,0.2063953488372093
72,2,29,292,248,44,0.8493150684931506,0.1506849315068493
73,2,30,293,238,55,0.8122866894197952,0.18771331058020477
74,2,31,484,425,59,0.878099173553719,0.12190082644628099
75,2,32,235,193,42,0.8212765957446808,0.17872340425531916
76,2,33,532,446,86,0.8383458646616542,0.16165413533834586
77,2,34,343,309,34,0.9008746355685131,0.09912536443148688
78,2,35,281,237,44,0.8434163701067615,0.15658362989323843
79,2,36,278,228,50,0.8201438848920863,0.17985611510791366
80,2,37,363,282,81,0.7768595041322314,0.2231404958677686
81,2,38,376,322,54,0.8563829787234043,0.14361702127659576
82,2,39,251,207,44,0.8247011952191236,0.1752988047808765
83,2,40,252,211,41,0.8373015873015873,0.1626984126984127
84,2,41,210,181,29,0.861904761904762,0.1380952380952381
85,2,42,279,210,69,0.7526881720430108,0.24731182795698925
86,2,43,355,301,54,0.847887323943662,0.15211267605633802
87,2,44,232,190,42,0.8189655172413793,0.1810344827586207
88,2,45,342,238,104,0.695906432748538,0.30409356725146197
89,2,46,187,155,32,0.8288770053475936,0.1711229946524064
90,3,1,345,198,147,0.5739130434782609,0.4260869565217391
91,3,2,448,307,141,0.6852678571428571,0.31473214285714285
92,3,3,343,241,102,0.7026239067055393,0.29737609329446063
93,3,4,351,177,174,0.5042735042735043,0.49572649572649574
94,3,5,223,147,76,0.6591928251121076,0.34080717488789236
95,3,6,346,261,85,0.7543352601156069,0.24566473988439305
96,3,7,279,155,124,0.5555555555555556,0.4444444444444444
97,3,8,229,134,95,0.5851528384279476,0.4148471615720524
98,3,9,304,175,129,0.5756578947368421,0.4243421052631579
99,3,10,158,94,64,0.5949367088607594,0.4050632911392405
100,3,11,304,171,133,0.5625,0.4375
101,3,12,365,211,154,0.5780821917808219,0.42191780821917807
102,3,13,369,277,92,0.7506775067750677,0.24932249322493225
103,3,14,260,183,77,0.7038461538461539,0.29615384615384616
104,3,15,283,156,127,0.5512367491166078,0.44876325088339225
105,3,16,291,179,112,0.6151202749140894,0.3848797250859107
106,3,17,309,204,105,0.6601941747572816,0.33980582524271846
107,3,18,432,264,168,0.6111111111111112,0.3888888888888889
108,3,19,337,253,84,0.7507418397626113,0.24925816023738873
109,3,20,318,182,136,0.5723270440251572,0.4276729559748428
110,3,21,402,293,109,0.7288557213930348,0.27114427860696516
111,3,22,296,204,92,0.6891891891891891,0.3108108108108108
112,3,23,291,177,114,0.6082474226804123,0.3917525773195876
113,3,24,291,188,103,0.6460481099656358,0.3539518900343643
114,3,25,458,372,86,0.8122270742358079,0.18777292576419213
115,3,26,450,358,92,0.7955555555555556,0.20444444444444446
116,3,27,313,222,91,0.7092651757188498,0.29073482428115016
117,3,28,267,194,73,0.7265917602996255,0.27340823970037453
118,3,29,312,200,112,0.6410256410256411,0.358974358974359
119,3,30,324,193,131,0.595679012345679,0.404320987654321
120,3,31,361,237,124,0.6565096952908587,0.34349030470914127
121,3,32,344,265,79,0.7703488372093024,0.22965116279069767
122,3,33,256,190,66,0.7421875,0.2578125
123,3,34,360,256,104,0.7111111111111111,0.28888888888888886
124,3,35,163,85,78,0.5214723926380368,0.4785276073619632
125,3,36,174,100,74,0.5747126436781609,0.42528735632183906
126,3,37,254,148,106,0.5826771653543307,0.41732283464566927
127,3,38,350,249,101,0.7114285714285714,0.2885714285714286
128,3,39,302,250,52,0.8278145695364238,0.17218543046357615
129,3,40,367,225,142,0.6130790190735694,0.3869209809264305
130,3,41,290,182,108,0.6275862068965518,0.3724137931034483
131,4,1,399,138,261,0.3458646616541353,0.6541353383458647
132,4,2,376,295,81,0.7845744680851063,0.2154255319148936
133,4,3,305,172,133,0.5639344262295082,0.4360655737704918
134,4,4,412,227,185,0.5509708737864077,0.44902912621359226
135,4,5,342,178,164,0.52046783625731,0.47953216374269003
136,4,6,488,307,181,0.6290983606557377,0.3709016393442623
137,4,7,410,234,176,0.5707317073170731,0.4292682926829268
138,4,8,416,221,195,0.53125,0.46875
139,4,9,485,251,234,0.5175257731958763,0.4824742268041237
140,4,10,398,225,173,0.5653266331658291,0.43467336683417085
141,4,11,340,221,119,0.65,0.35
142,4,12,351,193,158,0.5498575498575499,0.45014245014245013
143,4,13,192,130,62,0.6770833333333334,0.3229166666666667
144,4,14,353,199,154,0.5637393767705382,0.43626062322946174
145,4,15,400,240,160,0.6,0.4
146,4,16,347,254,93,0.7319884726224783,0.2680115273775216
147,4,17,341,235,106,0.6891495601173021,0.31085043988269795
148,4,18,362,221,141,0.6104972375690608,0.38950276243093923
149,4,19,312,180,132,0.5769230769230769,0.4230769230769231
150,4,20,346,242,104,0.6994219653179191,0.30057803468208094
151,4,21,304,195,109,0.6414473684210527,0.35855263157894735
152,4,22,403,237,166,0.5880893300248139,0.4119106699751861
153,4,23,461,238,223,0.5162689804772235,0.4837310195227766
154,4,24,337,205,132,0.6083086053412463,0.3916913946587537
155,4,25,340,253,87,0.7441176470588236,0.25588235294117645
156,4,26,377,227,150,0.6021220159151194,0.3978779840848806
157,4,27,355,137,218,0.38591549295774646,0.6140845070422535
158,4,28,356,214,142,0.601123595505618,0.398876404494382
159,4,29,269,141,128,0.5241635687732342,0.4758364312267658
160,4,30,386,230,156,0.5958549222797928,0.40414507772020725
161,4,31,457,287,170,0.6280087527352297,0.37199124726477023
162,4,32,331,185,146,0.5589123867069486,0.44108761329305135
163,4,33,393,207,186,0.5267175572519084,0.4732824427480916
164,4,34,280,154,126,0.55,0.45
165,4,35,457,273,184,0.5973741794310722,0.4026258205689278
166,4,36,395,223,172,0.5645569620253165,0.43544303797468353
167,4,37,324,233,91,0.7191358024691358,0.2808641975308642
168,4,38,397,242,155,0.6095717884130982,0.3904282115869018
169,5,1,271,166,105,0.6125461254612546,0.3874538745387454
170,5,2,259,133,126,0.5135135135135135,0.4864864864864865
171,5,3,343,130,213,0.37900874635568516,0.6209912536443148
172,5,4,316,163,153,0.5158227848101266,0.48417721518987344
173,5,5,328,173,155,0.5274390243902439,0.4725609756097561
174,5,6,268,139,129,0.5186567164179104,0.48134328358208955
175,5,7,309,194,115,0.627831715210356,0.37216828478964403
176,5,8,369,202,167,0.5474254742547425,0.45257452574525747
177,5,9,398,233,165,0.585427135678392,0.41457286432160806
178,5,10,261,143,118,0.5478927203065134,0.4521072796934866
179,5,11,379,181,198,0.47757255936675463,0.5224274406332454
180,5,12,227,134,93,0.5903083700440529,0.40969162995594716
181,5,13,270,153,117,0.5666666666666667,0.43333333333333335
182,5,14,316,186,130,0.5886075949367089,0.41139240506329117
183,5,15,323,171,152,0.5294117647058824,0.47058823529411764
184,5,16,314,191,123,0.60828025477707,0.39171974522292996
185,5,17,256,163,93,0.63671875,0.36328125
186,5,18,299,154,145,0.5150501672240803,0.48494983277591974
187,5,19,374,157,217,0.4197860962566845,0.5802139037433155
188,5,20,387,209,178,0.5400516795865633,0.4599483204134367
189,5,21,307,138,169,0.4495114006514658,0.5504885993485342
190,5,22,439,311,128,0.7084282460136674,0.29157175398633256
191,5,23,493,275,218,0.5578093306288032,0.4421906693711968
192,5,24,322,143,179,0.4440993788819876,0.5559006211180124
193,5,25,339,184,155,0.5427728613569321,0.45722713864306785
194,5,26,311,178,133,0.572347266881029,0.42765273311897106
195,5,27,292,153,139,0.523972602739726,0.476027397260274
196,5,28,386,226,160,0.5854922279792746,0.41450777202072536
197,5,29,376,179,197,0.47606382978723405,0.523936170212766
198,5,30,230,117,113,0.508695652173913,0.49130434782608695
199,5,31,229,121,108,0.5283842794759825,0.47161572052401746
200,5,32,410,234,176,0.5707317073170731,0.4292682926829268
201,5,33,355,214,141,0.6028169014084507,0.3971830985915493
202,5,34,404,245,159,0.6064356435643564,0.3935643564356436
203,5,35,365,196,169,0.536986301369863,0.46301369863013697
204,5,36,246,145,101,0.5894308943089431,0.4105691056910569
205,5,37,387,233,154,0.6020671834625323,0.3979328165374677
206,5,38,281,162,119,0.5765124555160143,0.4234875444839858
207,5,39,307,173,134,0.5635179153094463,0.4364820846905538
208,5,40,303,171,132,0.5643564356435643,0.43564356435643564
209,5,41,227,149,78,0.6563876651982379,0.3436123348017621
210,6,1,350,202,148,0.5771428571428572,0.4228571428571429
211,6,2,321,192,129,0.5981308411214953,0.40186915887850466
212,6,3,333,235,98,0.7057057057057057,0.29429429429429427
213,6,4,220,133,87,0.6045454545454545,0.39545454545454545
214,6,5,217,120,97,0.5529953917050692,0.4470046082949309
215,6,6,285,164,121,0.5754385964912281,0.4245614035087719
216,6,7,264,160,104,0.6060606060606061,0.3939393939393939
217,6,8,321,176,145,0.5482866043613707,0.4517133956386293
218,6,9,254,141,113,0.5551181102362205,0.4448818897637795
219,6,10,186,108,78,0.5806451612903226,0.41935483870967744
220,6,11,243,135,108,0.5555555555555556,0.4444444444444444
221,6,12,176,101,75,0.5738636363636364,0.42613636363636365
222,6,13,227,121,106,0.5330396475770925,0.4669603524229075
223,6,14,282,156,126,0.5531914893617021,0.44680851063829785
224,6,15,247,138,109,0.5587044534412956,0.44129554655870445
225,6,16,337,185,152,0.5489614243323442,0.45103857566765576
226,6,17,213,141,72,0.6619718309859155,0.3380281690140845
227,6,18,200,118,82,0.59,0.41
228,6,19,280,183,97,0.6535714285714286,0.3464285714285714
229,6,20,159,88,71,0.5534591194968553,0.44654088050314467
230,6,21,173,107,66,0.6184971098265896,0.3815028901734104
231,6,22,203,111,92,0.5467980295566502,0.45320197044334976
232,6,23,174,97,77,0.5574712643678161,0.4425287356321839
233,6,24,165,104,61,0.6303030303030303,0.3696969696969697
234,6,25,174,95,79,0.5459770114942529,0.4540229885057471
235,6,26,170,90,80,0.5294117647058824,0.47058823529411764
236,6,27,160,74,86,0.4625,0.5375
237,6,28,147,79,68,0.5374149659863946,0.46258503401360546
238,6,29,351,198,153,0.5641025641025641,0.4358974358974359
239,6,30,239,121,118,0.5062761506276151,0.49372384937238495
240,6,31,321,191,130,0.5950155763239875,0.40498442367601245
241,6,32,272,155,117,0.5698529411764706,0.43014705882352944
242,6,33,302,167,135,0.5529801324503312,0.4470198675496689
243,6,34,303,170,133,0.5610561056105611,0.4389438943894389
244,6,35,296,166,130,0.5608108108108109,0.4391891891891892
245,6,36,341,203,138,0.5953079178885631,0.4046920821114369
246,6,37,373,187,186,0.5013404825737265,0.49865951742627346
247,6,38,340,172,168,0.5058823529411764,0.49411764705882355
248,6,39,249,128,121,0.5140562248995983,0.4859437751004016
249,6,40,258,139,119,0.5387596899224806,0.46124031007751937
250,6,41,295,182,113,0.6169491525423729,0.38305084745762713
251,6,42,268,153,115,0.5708955223880597,0.4291044776119403
252,6,43,270,137,133,0.5074074074074074,0.4925925925925926
253,6,44,323,198,125,0.6130030959752322,0.38699690402476783
254,6,45,301,157,144,0.521594684385382,0.47840531561461797
255,6,46,219,119,100,0.54337899543379,0.45662100456621
256,6,47,229,132,97,0.5764192139737991,0.42358078602620086
257,6,48,284,171,113,0.602112676056338,0.397887323943662
258,7,1,229,119,110,0.519650655021834,0.48034934497816595
259,7,2,240,128,112,0.5333333333333333,0.4666666666666667
260,7,3,289,156,133,0.5397923875432526,0.4602076124567474
261,7,4,289,148,141,0.5121107266435986,0.48788927335640137
262,7,5,225,111,114,0.49333333333333335,0.5066666666666667
263,7,6,388,221,167,0.5695876288659794,0.43041237113402064
264,7,7,225,125,100,0.5555555555555556,0.4444444444444444
265,7,8,286,200,86,0.6993006993006993,0.3006993006993007
266,7,9,506,262,244,0.5177865612648221,0.48221343873517786
267,7,10,298,176,122,0.5906040268456376,0.40939597315436244
268,7,11,264,147,117,0.5568181818181818,0.4431818181818182
269,7,12,260,148,112,0.5692307692307692,0.4307692307692308
270,7,13,219,150,69,0.684931506849315,0.3150684931506849
271,7,14,268,156,112,0.582089552238806,0.417910447761194
272,7,15,302,152,150,0.5033112582781457,0.4966887417218543
273,7,16,226,122,104,0.5398230088495575,0.46017699115044247
274,7,17,213,119,94,0.5586854460093896,0.4413145539906103
275,7,18,228,124,104,0.543859649122807,0.45614035087719296
276,7,19,269,169,100,0.6282527881040892,0.37174721189591076
277,7,20,174,105,69,0.603448275862069,0.39655172413793105
278,7,21,196,109,87,0.5561224489795918,0.44387755102040816
279,7,22,209,112,97,0.5358851674641149,0.46411483253588515
280,7,23,317,171,146,0.5394321766561514,0.4605678233438486
281,7,24,263,143,120,0.5437262357414449,0.45627376425855515
282,7,25,239,112,127,0.4686192468619247,0.5313807531380753
283,7,26,230,131,99,0.5695652173913044,0.43043478260869567
284,7,27,231,142,89,0.6147186147186147,0.3852813852813853
285,7,28,207,113,94,0.5458937198067633,0.45410628019323673
286,7,29,233,155,78,0.6652360515021459,0.33476394849785407
287,7,30,208,105,103,0.5048076923076923,0.4951923076923077
288,7,31,171,80,91,0.4678362573099415,0.5321637426900585
289,7,32,434,262,172,0.6036866359447005,0.39631336405529954
290,7,33,407,251,156,0.6167076167076168,0.3832923832923833
291,7,34,364,208,156,0.5714285714285714,0.42857142857142855
292,7,35,272,131,141,0.48161764705882354,0.5183823529411765
293,7,36,353,190,163,0.5382436260623229,0.46175637393767704
294,7,37,336,193,143,0.5744047619047619,0.4255952380952381
295,7,38,198,124,74,0.6262626262626263,0.37373737373737376
296,7,39,279,160,119,0.5734767025089605,0.4265232974910394
297,7,40,289,167,122,0.5778546712802768,0.42214532871972316
298,7,41,262,143,119,0.5458015267175572,0.4541984732824427
299,7,42,275,159,116,0.5781818181818181,0.4218181818181818
300,7,43,269,158,111,0.587360594795539,0.41263940520446096
301,7,44,247,148,99,0.5991902834008097,0.4008097165991903
302,7,45,262,135,127,0.5152671755725191,0.4847328244274809
303,7,46,156,108,48,0.6923076923076923,0.3076923076923077
304,8,1,217,130,87,0.5990783410138248,0.4009216589861751
305,8,2,281,173,108,0.6156583629893239,0.38434163701067614
306,8,3,362,213,149,0.5883977900552486,0.4116022099447514
307,8,4,367,216,151,0.5885558583106267,0.4114441416893733
308,8,5,373,212,161,0.5683646112600537,0.4316353887399464
309,8,6,322,197,125,0.6118012422360248,0.38819875776397517
310,8,7,362,213,149,0.5883977900552486,0.4116022099447514
311,8,8,335,184,151,0.5492537313432836,0.4507462686567164
312,8,9,195,115,80,0.5897435897435898,0.41025641025641024
313,8,10,399,221,178,0.5538847117794486,0.44611528822055135
314,8,11,275,167,108,0.6072727272727273,0.3927272727272727
315,8,12,250,138,112,0.552,0.448
316,8,13,320,197,123,0.615625,0.384375
317,8,14,182,104,78,0.5714285714285714,0.42857142857142855
318,8,15,252,141,111,0.5595238095238095,0.44047619047619047
319,8,16,91,52,39,0.5714285714285714,0.42857142857142855
320,8,17,280,178,102,0.6357142857142857,0.36428571428571427
321,8,18,240,153,87,0.6375,0.3625
322,8,19,361,189,172,0.5235457063711911,0.47645429362880887
323,8,20,313,175,138,0.5591054313099042,0.44089456869009586
324,8,21,343,193,150,0.5626822157434402,0.43731778425655976
325,8,22,269,172,97,0.6394052044609665,0.36059479553903345
326,8,23,225,115,110,0.5111111111111111,0.4888888888888889
327,8,24,198,109,89,0.5505050505050505,0.4494949494949495
328,8,25,295,181,114,0.6135593220338983,0.3864406779661017
329,8,26,275,168,107,0.610909090909091,0.3890909090909091
330,8,27,331,185,146,0.5589123867069486,0.44108761329305135
331,8,28,304,164,140,0.5394736842105263,0.4605263157894737
332,8,29,329,182,147,0.5531914893617021,0.44680851063829785
333,8,30,323,197,126,0.6099071207430341,0.39009287925696595
334,8,31,225,138,87,0.6133333333333333,0.38666666666666666
335,8,32,244,143,101,0.5860655737704918,0.4139344262295082
336,8,33,283,178,105,0.6289752650176679,0.3710247349823322
337,8,34,289,190,99,0.657439446366782,0.34256055363321797
338,8,35,351,195,156,0.5555555555555556,0.4444444444444444
339,8,36,319,190,129,0.5956112852664577,0.4043887147335423
340,8,37,273,155,118,0.5677655677655677,0.43223443223443225
341,8,38,207,130,77,0.6280193236714976,0.3719806763285024
342,8,39,302,187,115,0.6192052980132451,0.38079470198675497
343,8,40,226,149,77,0.6592920353982301,0.3407079646017699
344,8,41,307,178,129,0.5798045602605864,0.4201954397394137
345,8,42,355,194,161,0.5464788732394367,0.4535211267605634
346,8,43,156,87,69,0.5576923076923077,0.4423076923076923
347,8,44,184,97,87,0.5271739130434783,0.47282608695652173
348,8,45,237,136,101,0.5738396624472574,0.42616033755274263
349,8,46,240,120,120,0.5,0.5
350,8,47,256,163,93,0.63671875,0.36328125
351,8,48,238,137,101,0.5756302521008403,0.42436974789915966
352,8,49,296,162,134,0.5472972972972973,0.4527027027027027
353,8,50,330,207,123,0.6272727272727273,0.37272727272727274
354,8,51,331,175,156,0.5287009063444109,0.47129909365558914
355,8,52,406,233,173,0.5738916256157636,0.42610837438423643
356,8,53,168,105,63,0.625,0.375
357,8,54,227,135,92,0.5947136563876652,0.4052863436123348
358,8,55,187,120,67,0.6417112299465241,0.3582887700534759
359,8,56,320,205,115,0.640625,0.359375
360,9,1,286,186,100,0.6503496503496503,0.34965034965034963
361,9,2,236,143,93,0.6059322033898306,0.3940677966101695
362,9,3,152,91,61,0.5986842105263158,0.40131578947368424
363,9,4,226,131,95,0.5796460176991151,0.42035398230088494
364,9,5,260,159,101,0.6115384615384616,0.38846153846153847
365,9,6,304,175,129,0.5756578947368421,0.4243421052631579
366,9,7,190,108,82,0.5684210526315789,0.43157894736842106
367,9,8,227,129,98,0.5682819383259912,0.43171806167400884
368,9,9,340,199,141,0.5852941176470589,0.4147058823529412
369,9,10,240,132,108,0.55,0.45
370,9,11,194,121,73,0.6237113402061856,0.37628865979381443
371,9,12,311,181,130,0.5819935691318328,0.4180064308681672
372,9,13,333,194,139,0.5825825825825826,0.4174174174174174
373,9,14,366,218,148,0.5956284153005464,0.40437158469945356
374,9,15,156,93,63,0.5961538461538461,0.40384615384615385
375,9,16,242,156,86,0.6446280991735537,0.35537190082644626
376,9,17,201,121,80,0.6019900497512438,0.39800995024875624
377,9,18,194,112,82,0.5773195876288659,0.422680412371134
378,9,19,240,133,107,0.5541666666666667,0.44583333333333336
379,9,20,295,178,117,0.6033898305084746,0.39661016949152544
380,9,21,257,154,103,0.5992217898832685,0.40077821011673154
381,9,22,306,178,128,0.5816993464052288,0.41830065359477125
382,9,23,333,185,148,0.5555555555555556,0.4444444444444444
383,9,24,285,186,99,0.6526315789473685,0.3473684210526316
384,9,25,287,154,133,0.5365853658536586,0.4634146341463415
385,9,26,190,98,92,0.5157894736842106,0.4842105263157895
386,9,27,253,155,98,0.6126482213438735,0.38735177865612647
387,9,28,164,71,93,0.4329268292682927,0.5670731707317073
388,9,29,262,143,119,0.5458015267175572,0.4541984732824427
389,9,30,222,134,88,0.6036036036036037,0.3963963963963964
390,9,31,210,127,83,0.6047619047619047,0.3952380952380952
391,9,32,255,145,110,0.5686274509803921,0.43137254901960786
392,9,33,188,126,62,0.6702127659574468,0.32978723404255317
393,9,34,218,131,87,0.6009174311926605,0.39908256880733944
394,9,35,279,165,114,0.5913978494623656,0.40860215053763443
395,9,36,226,123,103,0.5442477876106194,0.4557522123893805
396,9,37,336,193,143,0.5744047619047619,0.4255952380952381
397,9,38,268,175,93,0.6529850746268657,0.34701492537313433
398,9,39,287,168,119,0.5853658536585366,0.4146341463414634
399,9,40,314,190,124,0.6050955414012739,0.39490445859872614
400,9,41,226,141,85,0.6238938053097345,0.37610619469026546
401,9,42,330,166,164,0.503030303030303,0.49696969696969695
402,9,43,216,139,77,0.6435185185185185,0.35648148148148145
403,9,44,248,102,146,0.4112903225806452,0.5887096774193549
404,9,45,213,131,82,0.6150234741784038,0.38497652582159625
405,9,46,258,152,106,0.5891472868217055,0.4108527131782946
406,9,47,341,195,146,0.5718475073313783,0.4281524926686217
407,9,48,315,162,153,0.5142857142857142,0.4857142857142857
408,9,49,307,183,124,0.5960912052117264,0.40390879478827363
409,9,50,387,211,176,0.5452196382428941,0.45478036175710596
410,9,51,302,185,117,0.6125827814569537,0.38741721854304634
411,10,1,250,127,123,0.508,0.492
412,10,2,379,196,183,0.5171503957783641,0.48284960422163586
413,10,3,367,223,144,0.6076294277929155,0.3923705722070845
414,10,4,257,91,166,0.3540856031128405,0.6459143968871596
415,10,5,305,163,142,0.5344262295081967,0.46557377049180326
416,10,6,300,124,176,0.41333333333333333,0.5866666666666667
417,10,7,232,76,156,0.3275862068965517,0.6724137931034483
418,10,8,165,67,98,0.40606060606060607,0.593939393939394
419,10,9,391,206,185,0.5268542199488491,0.4731457800511509
420,10,10,376,162,214,0.4308510638297872,0.5691489361702128
421,10,11,478,148,330,0.30962343096234307,0.6903765690376569
422,10,12,249,93,156,0.37349397590361444,0.6265060240963856
423,10,13,367,125,242,0.3405994550408719,0.659400544959128
424,10,14,497,163,334,0.32796780684104626,0.6720321931589537
425,10,15,552,287,265,0.519927536231884,0.48007246376811596
426,10,16,278,160,118,0.5755395683453237,0.4244604316546763
427,10,17,494,260,234,0.5263157894736842,0.47368421052631576
428,10,18,193,74,119,0.38341968911917096,0.616580310880829
429,10,19,417,169,248,0.4052757793764988,0.5947242206235012
430,10,20,412,173,239,0.4199029126213592,0.5800970873786407
431,10,21,388,120,268,0.30927835051546393,0.6907216494845361
432,10,22,190,40,150,0.21052631578947367,0.7894736842105263
433,10,23,337,98,239,0.29080118694362017,0.7091988130563798
434,10,24,408,223,185,0.5465686274509803,0.4534313725490196
435,10,25,95,38,57,0.4,0.6
436,10,26,266,76,190,0.2857142857142857,0.7142857142857143
437,10,27,284,108,176,0.38028169014084506,0.6197183098591549
438,10,28,423,108,315,0.2553191489361702,0.7446808510638298
439,10,29,335,99,236,0.2955223880597015,0.7044776119402985
440,10,30,322,84,238,0.2608695652173913,0.7391304347826086
441,10,31,258,70,188,0.2713178294573643,0.7286821705426356
442,10,32,360,146,214,0.40555555555555556,0.5944444444444444
443,10,33,251,67,184,0.26693227091633465,0.7330677290836654
444,10,34,211,66,145,0.3127962085308057,0.6872037914691943
445,10,35,449,211,238,0.46993318485523383,0.5300668151447662
446,10,36,87,31,56,0.3563218390804598,0.6436781609195402
447,11,1,385,244,141,0.6337662337662338,0.36623376623376624
448,11,2,41,17,24,0.4146341463414634,0.5853658536585366
449,11,3,267,74,193,0.27715355805243447,0.7228464419475655
450,11,4,355,164,191,0.4619718309859155,0.5380281690140845
451,11,5,430,178,252,0.413953488372093,0.586046511627907
452,11,6,324,206,118,0.6358024691358025,0.36419753086419754
453,11,7,244,140,104,0.5737704918032787,0.4262295081967213
454,11,8,364,192,172,0.5274725274725275,0.4725274725274725
455,11,9,338,178,160,0.5266272189349113,0.47337278106508873
456,11,10,368,235,133,0.6385869565217391,0.36141304347826086
457,11,11,406,222,184,0.5467980295566502,0.45320197044334976
458,11,12,615,366,249,0.5951219512195122,0.40487804878048783
459,11,13,555,339,216,0.6108108108108108,0.3891891891891892
460,11,14,249,182,67,0.7309236947791165,0.26907630522088355
461,11,15,168,127,41,0.7559523809523809,0.24404761904761904
462,11,16,300,181,119,0.6033333333333334,0.39666666666666667
463,11,17,393,219,174,0.5572519083969466,0.44274809160305345
464,11,18,355,253,102,0.7126760563380282,0.28732394366197184
465,11,19,438,223,215,0.5091324200913242,0.4908675799086758
466,11,20,303,218,85,0.7194719471947195,0.28052805280528054
467,11,21,583,407,176,0.6981132075471698,0.3018867924528302
468,11,22,484,273,211,0.5640495867768595,0.4359504132231405
469,11,23,271,202,69,0.7453874538745388,0.25461254612546125
470,11,24,503,378,125,0.7514910536779325,0.2485089463220676
471,11,25,404,247,157,0.6113861386138614,0.3886138613861386
472,11,26,508,327,181,0.6437007874015748,0.3562992125984252
473,11,27,158,96,62,0.6075949367088608,0.3924050632911392
474,11,28,205,127,78,0.6195121951219512,0.3804878048780488
475,11,29,499,325,174,0.6513026052104208,0.3486973947895792
476,11,30,233,180,53,0.7725321888412017,0.22746781115879827
477,11,31,441,274,167,0.6213151927437641,0.3786848072562358
478,11,32,237,189,48,0.7974683544303798,0.20253164556962025
479,11,33,300,200,100,0.6666666666666666,0.3333333333333333
480,11,34,164,130,34,0.7926829268292683,0.2073170731707317
481,11,35,154,109,45,0.7077922077922078,0.2922077922077922
482,11,36,178,119,59,0.6685393258426966,0.33146067415730335
483,11,37,138,102,36,0.7391304347826086,0.2608695652173913
484,11,38,150,36,114,0.24,0.76
485,12,1,333,104,229,0.3123123123123123,0.6876876876876877
486,12,2,255,73,182,0.28627450980392155,0.7137254901960784
487,12,3,379,114,265,0.3007915567282322,0.6992084432717678
488,12,4,330,101,229,0.30606060606060603,0.693939393939394
489,12,5,289,124,165,0.4290657439446367,0.5709342560553633
490,12,6,327,104,223,0.3180428134556575,0.6819571865443425
491,12,7,261,29,232,0.1111111111111111,0.8888888888888888
492,12,8,331,128,203,0.3867069486404834,0.6132930513595166
493,12,9,286,83,203,0.2902097902097902,0.7097902097902098
494,12,10,302,39,263,0.1291390728476821,0.8708609271523179
495,12,11,326,56,270,0.17177914110429449,0.8282208588957055
496,12,12,267,74,193,0.27715355805243447,0.7228464419475655
497,12,13,316,84,232,0.26582278481012656,0.7341772151898734
498,12,14,241,25,216,0.1037344398340249,0.8962655601659751
499,12,15,305,76,229,0.24918032786885247,0.7508196721311475
500,12,16,294,37,257,0.12585034013605442,0.8741496598639455
501,12,17,323,91,232,0.28173374613003094,0.718266253869969
502,12,18,269,33,236,0.12267657992565056,0.8773234200743495
503,12,19,304,68,236,0.2236842105263158,0.7763157894736842
504,12,20,354,79,275,0.2231638418079096,0.7768361581920904
505,12,21,316,98,218,0.310126582278481,0.689873417721519
506,12,22,242,30,212,0.12396694214876033,0.8760330578512396
507,12,23,311,107,204,0.3440514469453376,0.6559485530546624
508,13,1,267,166,101,0.6217228464419475,0.3782771535580524
509,13,2,305,207,98,0.6786885245901639,0.32131147540983607
510,13,3,218,80,138,0.3669724770642202,0.6330275229357798
511,13,4,335,215,120,0.6417910447761194,0.3582089552238806
512,13,5,351,153,198,0.4358974358974359,0.5641025641025641
513,13,6,325,218,107,0.6707692307692308,0.3292307692307692
514,13,7,242,125,117,0.5165289256198347,0.4834710743801653
515,13,8,231,120,111,0.5194805194805194,0.4805194805194805
516,13,9,288,153,135,0.53125,0.46875
517,13,10,317,212,105,0.668769716088328,0.3312302839116719
518,13,11,366,218,148,0.5956284153005464,0.40437158469945356
519,13,12,285,145,140,0.5087719298245614,0.49122807017543857
520,13,13,312,139,173,0.44551282051282054,0.5544871794871795
521,13,14,271,130,141,0.4797047970479705,0.5202952029520295
522,13,15,438,240,198,0.547945205479452,0.4520547945205479
523,13,16,237,108,129,0.45569620253164556,0.5443037974683544
524,13,17,261,149,112,0.5708812260536399,0.42911877394636017
525,13,18,243,148,95,0.6090534979423868,0.39094650205761317
526,13,19,322,121,201,0.37577639751552794,0.6242236024844721
527,13,20,194,123,71,0.634020618556701,0.36597938144329895
528,13,21,371,247,124,0.6657681940700808,0.33423180592991913
529,13,22,353,220,133,0.623229461756374,0.37677053824362605
530,13,23,233,104,129,0.44635193133047213,0.5536480686695279
531,13,24,289,157,132,0.5432525951557093,0.45674740484429066
532,13,25,307,156,151,0.50814332247557,0.49185667752442996
533,13,26,310,204,106,0.6580645161290323,0.3419354838709677
534,13,27,307,187,120,0.6091205211726385,0.39087947882736157
535,13,28,252,112,140,0.4444444444444444,0.5555555555555556
536,13,29,248,112,136,0.45161290322580644,0.5483870967741935
537,13,30,233,104,129,0.44635193133047213,0.5536480686695279
538,13,31,325,199,126,0.6123076923076923,0.38769230769230767
539,13,32,277,180,97,0.6498194945848376,0.35018050541516244
540,13,33,294,189,105,0.6428571428571429,0.35714285714285715
541,13,34,359,184,175,0.5125348189415042,0.48746518105849584
542,13,35,281,126,155,0.4483985765124555,0.5516014234875445
543,13,36,169,74,95,0.4378698224852071,0.5621301775147929
544,13,37,333,186,147,0.5585585585585585,0.44144144144144143
545,13,38,283,171,112,0.6042402826855123,0.3957597173144876
546,13,39,310,147,163,0.47419354838709676,0.5258064516129032
547,13,40,254,149,105,0.5866141732283464,0.41338582677165353
548,13,41,284,128,156,0.4507042253521127,0.5492957746478874
549,13,42,310,192,118,0.6193548387096774,0.38064516129032255
550,13,43,328,193,135,0.5884146341463414,0.4115853658536585
551,13,44,409,310,99,0.7579462102689487,0.24205378973105135
552,13,45,302,208,94,0.6887417218543046,0.31125827814569534
553,13,46,357,139,218,0.38935574229691877,0.6106442577030813
554,13,47,313,142,171,0.4536741214057508,0.5463258785942492
555,13,48,283,197,86,0.696113074204947,0.303886925795053
556,14,1,416,246,170,0.5913461538461539,0.40865384615384615
557,14,2,421,155,266,0.3681710213776722,0.6318289786223278
558,14,3,295,75,220,0.2542372881355932,0.7457627118644068
559,14,4,321,194,127,0.6043613707165109,0.3956386292834891
560,14,5,372,88,284,0.23655913978494625,0.7634408602150538
561,14,6,146,42,104,0.2876712328767123,0.7123287671232876
562,14,7,326,92,234,0.2822085889570552,0.7177914110429447
563,14,8,303,81,222,0.26732673267326734,0.7326732673267327
564,14,9,360,202,158,0.5611111111111111,0.4388888888888889
565,14,10,220,72,148,0.32727272727272727,0.6727272727272727
566,14,11,171,55,116,0.3216374269005848,0.6783625730994152
567,14,12,312,128,184,0.41025641025641024,0.5897435897435898
568,14,13,238,88,150,0.3697478991596639,0.6302521008403361
569,14,14,273,75,198,0.27472527472527475,0.7252747252747253
570,14,15,302,76,226,0.25165562913907286,0.7483443708609272
571,14,16,227,74,153,0.32599118942731276,0.6740088105726872
572,14,17,257,77,180,0.29961089494163423,0.7003891050583657
573,14,18,136,56,80,0.4117647058823529,0.5882352941176471
574,14,19,274,59,215,0.21532846715328466,0.7846715328467153
575,14,20,191,53,138,0.2774869109947644,0.7225130890052356
576,14,21,289,52,237,0.17993079584775087,0.8200692041522492
577,14,22,331,147,184,0.44410876132930516,0.5558912386706949
578,14,23,263,138,125,0.5247148288973384,0.4752851711026616
579,14,24,406,235,171,0.5788177339901478,0.4211822660098522
580,14,25,188,34,154,0.18085106382978725,0.8191489361702128
581,14,26,192,33,159,0.171875,0.828125
582,14,27,267,108,159,0.4044943820224719,0.5955056179775281
583,14,28,234,92,142,0.39316239316239315,0.6068376068376068
584,14,29,256,73,183,0.28515625,0.71484375
585,14,30,155,29,126,0.1870967741935484,0.8129032258064516
586,14,31,175,33,142,0.18857142857142858,0.8114285714285714
587,15,1,337,57,280,0.16913946587537093,0.8308605341246291
588,15,2,172,105,67,0.6104651162790697,0.38953488372093026
589,15,3,184,100,84,0.5434782608695652,0.45652173913043476
590,15,4,340,68,272,0.2,0.8
591,15,5,275,47,228,0.1709090909090909,0.8290909090909091
592,15,6,303,73,230,0.24092409240924093,0.759075907590759
593,15,7,225,121,104,0.5377777777777778,0.4622222222222222
594,15,8,333,63,270,0.1891891891891892,0.8108108108108109
595,15,9,386,68,318,0.17616580310880828,0.8238341968911918
596,15,10,373,86,287,0.23056300268096513,0.7694369973190348
597,15,11,340,74,266,0.21764705882352942,0.7823529411764706
598,15,12,390,89,301,0.2282051282051282,0.7717948717948718
599,15,13,258,46,212,0.17829457364341086,0.8217054263565892
600,15,14,229,30,199,0.13100436681222707,0.868995633187773
601,15,15,224,48,176,0.21428571428571427,0.7857142857142857
602,15,16,310,77,233,0.24838709677419354,0.7516129032258064
603,15,17,231,138,93,0.5974025974025974,0.4025974025974026
604,15,18,199,105,94,0.5276381909547738,0.4723618090452261
605,15,19,264,89,175,0.3371212121212121,0.6628787878787878
606,15,20,180,90,90,0.5,0.5
607,15,21,187,108,79,0.5775401069518716,0.42245989304812837
608,15,22,202,107,95,0.5297029702970297,0.47029702970297027
609,15,23,216,133,83,0.6157407407407407,0.38425925925925924
610,15,24,189,92,97,0.48677248677248675,0.5132275132275133
611,16,1,311,65,246,0.2090032154340836,0.7909967845659164
612,16,2,219,131,88,0.5981735159817352,0.4018264840182648
613,16,3,209,134,75,0.6411483253588517,0.3588516746411483
614,16,4,226,123,103,0.5442477876106194,0.4557522123893805
615,16,5,185,97,88,0.5243243243243243,0.4756756756756757
616,16,6,207,111,96,0.5362318840579711,0.463768115942029
617,16,7,222,101,121,0.45495495495495497,0.545045045045045
618,16,8,132,80,52,0.6060606060606061,0.3939393939393939
619,16,9,245,147,98,0.6,0.4
620,16,10,217,129,88,0.5944700460829493,0.4055299539170507
621,16,11,227,104,123,0.4581497797356828,0.5418502202643172
622,16,12,178,103,75,0.5786516853932584,0.42134831460674155
623,16,13,216,78,138,0.3611111111111111,0.6388888888888888
624,16,14,185,107,78,0.5783783783783784,0.42162162162162165
625,16,15,252,162,90,0.6428571428571429,0.35714285714285715
626,16,16,256,143,113,0.55859375,0.44140625
627,16,17,228,88,140,0.38596491228070173,0.6140350877192983
628,16,18,250,111,139,0.444,0.556
629,16,19,190,92,98,0.4842105263157895,0.5157894736842106
630,16,20,206,130,76,0.6310679611650486,0.36893203883495146
631,16,21,186,100,86,0.5376344086021505,0.46236559139784944
632,16,22,198,106,92,0.5353535353535354,0.46464646464646464
633,16,23,225,60,165,0.26666666666666666,0.7333333333333333
634,16,24,151,86,65,0.5695364238410596,0.4304635761589404
635,16,25,249,150,99,0.6024096385542169,0.39759036144578314
636,16,26,219,123,96,0.5616438356164384,0.4383561643835616
637,16,27,189,106,83,0.5608465608465608,0.43915343915343913
638,16,28,277,160,117,0.5776173285198556,0.4223826714801444
639,16,29,199,109,90,0.5477386934673367,0.45226130653266333
640,16,30,209,122,87,0.583732057416268,0.41626794258373206
641,16,31,246,154,92,0.6260162601626016,0.37398373983739835
642,16,32,234,60,174,0.2564102564102564,0.7435897435897436
643,16,33,235,134,101,0.5702127659574469,0.4297872340425532
644,16,34,209,129,80,0.6172248803827751,0.3827751196172249
645,16,35,220,72,148,0.32727272727272727,0.6727272727272727
646,16,36,188,116,72,0.6170212765957447,0.3829787234042553
647,17,1,259,78,181,0.30115830115830117,0.6988416988416989
648,17,2,237,128,109,0.540084388185654,0.459915611814346
649,17,3,226,129,97,0.5707964601769911,0.42920353982300885
650,17,4,300,196,104,0.6533333333333333,0.3466666666666667
651,17,5,229,128,101,0.5589519650655022,0.4410480349344978
652,17,6,224,114,110,0.5089285714285714,0.49107142857142855
653,17,7,181,62,119,0.3425414364640884,0.6574585635359116
654,17,8,231,123,108,0.5324675324675324,0.4675324675324675
655,17,9,263,147,116,0.55893536121673,0.44106463878326996
656,17,10,278,158,120,0.5683453237410072,0.4316546762589928
657,17,11,217,130,87,0.5990783410138248,0.4009216589861751
658,17,12,268,102,166,0.3805970149253731,0.6194029850746269
659,17,13,207,123,84,0.5942028985507246,0.4057971014492754
660,17,14,262,124,138,0.4732824427480916,0.5267175572519084
661,17,15,260,137,123,0.5269230769230769,0.47307692307692306
662,17,16,226,97,129,0.42920353982300885,0.5707964601769911
663,17,17,234,134,100,0.5726495726495726,0.42735042735042733
664,17,18,295,181,114,0.6135593220338983,0.3864406779661017
665,17,19,142,80,62,0.5633802816901409,0.43661971830985913
666,17,20,343,196,147,0.5714285714285714,0.42857142857142855
667,17,21,353,200,153,0.56657223796034,0.43342776203966005
668,17,22,276,147,129,0.532608695652174,0.4673913043478261
669,17,23,177,98,79,0.5536723163841808,0.4463276836158192
670,17,24,300,192,108,0.64,0.36
671,17,25,202,117,85,0.5792079207920792,0.4207920792079208
672,17,26,313,191,122,0.610223642172524,0.38977635782747605
673,17,27,236,137,99,0.5805084745762712,0.4194915254237288
674,17,28,211,117,94,0.5545023696682464,0.44549763033175355
675,17,29,220,142,78,0.6454545454545455,0.35454545454545455
676,17,30,228,87,141,0.3815789473684211,0.618421052631579
677,17,31,190,105,85,0.5526315789473685,0.4473684210526316
678,17,32,175,112,63,0.64,0.36
679,17,33,165,93,72,0.5636363636363636,0.43636363636363634
680,17,34,188,105,83,0.5585106382978723,0.44148936170212766
681,17,35,195,114,81,0.5846153846153846,0.4153846153846154
682,17,36,295,163,132,0.5525423728813559,0.44745762711864406
683,17,37,219,132,87,0.6027397260273972,0.3972602739726027
684,17,38,288,170,118,0.5902777777777778,0.4097222222222222
685,17,39,263,146,117,0.5551330798479087,0.4448669201520912
686,17,40,256,147,109,0.57421875,0.42578125
687,17,41,311,202,109,0.6495176848874598,0.3504823151125402
688,18,1,231,108,123,0.4675324675324675,0.5324675324675324
689,18,2,272,108,164,0.39705882352941174,0.6029411764705882
690,18,3,321,145,176,0.4517133956386293,0.5482866043613707
691,18,4,314,156,158,0.4968152866242038,0.5031847133757962
692,18,5,202,141,61,0.698019801980198,0.30198019801980197
693,18,6,273,162,111,0.5934065934065934,0.4065934065934066
694,18,7,297,158,139,0.531986531986532,0.468013468013468
695,18,8,312,166,146,0.532051282051282,0.46794871794871795
696,18,9,309,176,133,0.56957928802589,0.43042071197411
697,18,10,394,215,179,0.5456852791878173,0.4543147208121827
698,18,11,255,128,127,0.5019607843137255,0.4980392156862745
699,18,12,273,161,112,0.5897435897435898,0.41025641025641024
700,18,13,318,156,162,0.49056603773584906,0.5094339622641509
701,18,14,299,163,136,0.5451505016722408,0.45484949832775917
702,18,15,320,131,189,0.409375,0.590625
703,18,16,296,166,130,0.5608108108108109,0.4391891891891892
704,18,17,312,153,159,0.49038461538461536,0.5096153846153846
705,18,18,279,170,109,0.6093189964157706,0.3906810035842294
706,18,19,305,178,127,0.5836065573770491,0.4163934426229508
707,18,20,251,148,103,0.5896414342629482,0.4103585657370518
708,18,21,381,194,187,0.5091863517060368,0.49081364829396323
709,18,22,356,202,154,0.5674157303370787,0.43258426966292135
710,18,23,270,139,131,0.5148148148148148,0.48518518518518516
711,18,24,288,124,164,0.4305555555555556,0.5694444444444444
712,18,25,304,122,182,0.40131578947368424,0.5986842105263158
713,18,26,364,199,165,0.5467032967032966,0.4532967032967033
714,18,27,226,119,107,0.5265486725663717,0.47345132743362833
715,18,28,294,154,140,0.5238095238095238,0.47619047619047616
716,18,29,308,154,154,0.5,0.5
717,18,30,327,155,172,0.4740061162079511,0.5259938837920489
718,18,31,300,130,170,0.43333333333333335,0.5666666666666667
719,18,32,314,189,125,0.6019108280254777,0.3980891719745223
720,18,33,238,126,112,0.5294117647058824,0.47058823529411764
721,18,34,405,236,169,0.582716049382716,0.41728395061728396
722,18,35,368,204,164,0.5543478260869565,0.44565217391304346
723,18,36,293,147,146,0.5017064846416383,0.49829351535836175
724,18,37,358,178,180,0.4972067039106145,0.5027932960893855
725,18,38,294,158,136,0.5374149659863946,0.46258503401360546
726,18,39,210,110,100,0.5238095238095238,0.47619047619047616
727,18,40,351,151,200,0.4301994301994302,0.5698005698005698
728,18,41,357,204,153,0.5714285714285714,0.42857142857142855
729,18,42,249,143,106,0.5742971887550201,0.42570281124497994
730,18,43,241,96,145,0.3983402489626556,0.6016597510373444
731,18,44,287,144,143,0.5017421602787456,0.49825783972125437
732,18,45,286,108,178,0.3776223776223776,0.6223776223776224
733,18,46,341,144,197,0.4222873900293255,0.5777126099706745
734,18,47,198,100,98,0.5050505050505051,0.494949494949495
735,18,48,218,125,93,0.573394495412844,0.42660550458715596
736,18,49,195,101,94,0.517948717948718,0.48205128205128206
737,18,50,218,126,92,0.5779816513761468,0.42201834862385323
738,19,1,320,228,92,0.7125,0.2875
739,19,2,486,306,180,0.6296296296296297,0.37037037037037035
740,19,3,282,168,114,0.5957446808510638,0.40425531914893614
741,19,4,407,248,159,0.6093366093366094,0.3906633906633907
742,19,5,395,247,148,0.6253164556962025,0.37468354430379747
743,19,6,379,196,183,0.5171503957783641,0.48284960422163586
744,19,7,340,212,128,0.6235294117647059,0.3764705882352941
745,19,8,409,222,187,0.5427872860635696,0.4572127139364303
746,19,9,253,166,87,0.6561264822134387,0.3438735177865613
747,19,10,409,256,153,0.6259168704156479,0.3740831295843521
748,19,11,389,246,143,0.6323907455012854,0.3676092544987147
749,19,12,297,178,119,0.5993265993265994,0.4006734006734007
750,19,13,402,212,190,0.527363184079602,0.472636815920398
751,19,14,382,244,138,0.6387434554973822,0.3612565445026178
752,19,15,477,258,219,0.5408805031446541,0.4591194968553459
753,19,16,382,226,156,0.5916230366492147,0.4083769633507853
754,19,17,301,173,128,0.574750830564784,0.42524916943521596
755,19,18,318,187,131,0.5880503144654088,0.4119496855345912
756,19,19,460,279,181,0.6065217391304348,0.3934782608695652
757,19,20,321,184,137,0.573208722741433,0.42679127725856697
758,19,21,330,200,130,0.6060606060606061,0.3939393939393939
759,19,22,387,223,164,0.5762273901808785,0.42377260981912146
760,19,23,375,235,140,0.6266666666666667,0.37333333333333335
761,19,24,295,182,113,0.6169491525423729,0.38305084745762713
762,19,25,339,228,111,0.672566371681416,0.3274336283185841
763,19,26,344,247,97,0.7180232558139535,0.2819767441860465
764,19,27,339,176,163,0.5191740412979351,0.4808259587020649
765,19,28,390,206,184,0.5282051282051282,0.4717948717948718
766,19,29,343,186,157,0.5422740524781341,0.4577259475218659
767,19,30,319,203,116,0.6363636363636364,0.36363636363636365
768,19,31,311,186,125,0.5980707395498392,0.40192926045016075
769,19,32,316,190,126,0.6012658227848101,0.3987341772151899
770,19,33,356,200,156,0.5617977528089888,0.43820224719101125
771,19,34,339,228,111,0.672566371681416,0.3274336283185841
772,19,35,312,199,113,0.6378205128205128,0.36217948717948717
773,19,36,406,233,173,0.5738916256157636,0.42610837438423643
774,19,37,350,175,175,0.5,0.5
775,19,38,302,174,128,0.5761589403973509,0.423841059602649
776,19,39,87,48,39,0.5517241379310345,0.4482758620689655
777,19,40,376,222,154,0.5904255319148937,0.4095744680851064
778,19,41,334,190,144,0.5688622754491018,0.4311377245508982
779,19,42,284,153,131,0.5387323943661971,0.4612676056338028
780,19,43,426,236,190,0.5539906103286385,0.4460093896713615
781,19,44,393,241,152,0.6132315521628499,0.38676844783715014
782,19,45,348,207,141,0.5948275862068966,0.4051724137931034
783,19,46,377,257,120,0.6816976127320955,0.3183023872679045
784,19,47,489,258,231,0.5276073619631901,0.4723926380368098
785,19,48,347,209,138,0.6023054755043228,0.3976945244956772
786,19,49,435,232,203,0.5333333333333333,0.4666666666666667
787,19,50,271,150,121,0.5535055350553506,0.44649446494464945
788,19,51,413,292,121,0.7070217917675545,0.2929782082324455
789,19,52,390,201,189,0.5153846153846153,0.4846153846153846
790,19,53,332,207,125,0.6234939759036144,0.37650602409638556
791,19,54,279,146,133,0.5232974910394266,0.4767025089605735
792,19,55,314,191,123,0.60828025477707,0.39171974522292996
793,19,56,384,254,130,0.6614583333333334,0.3385416666666667
794,19,57,303,171,132,0.5643564356435643,0.43564356435643564
795,20,1,216,114,102,0.5277777777777778,0.4722222222222222
796,20,2,116,75,41,0.646551724137931,0.35344827586206895
797,20,3,219,122,97,0.5570776255707762,0.4429223744292237
798,20,4,121,60,61,0.49586776859504134,0.5041322314049587
799,20,5,253,126,127,0.4980237154150198,0.5019762845849802
800,20,6,128,78,50,0.609375,0.390625
801,20,7,212,115,97,0.5424528301886793,0.45754716981132076
802,20,8,280,172,108,0.6142857142857143,0.38571428571428573
803,20,9,319,174,145,0.5454545454545454,0.45454545454545453
804,20,10,196,108,88,0.5510204081632653,0.4489795918367347
805,20,11,300,163,137,0.5433333333333333,0.45666666666666667
806,20,12,133,67,66,0.5037593984962406,0.49624060150375937
807,20,13,283,157,126,0.5547703180212014,0.4452296819787986
808,20,14,168,95,73,0.5654761904761905,0.43452380952380953
809,20,15,224,41,183,0.18303571428571427,0.8169642857142857
810,20,16,298,151,147,0.5067114093959731,0.49328859060402686
811,20,17,157,69,88,0.4394904458598726,0.5605095541401274
812,20,18,206,126,80,0.6116504854368932,0.3883495145631068
813,20,19,257,146,111,0.5680933852140078,0.43190661478599224
814,20,20,173,33,140,0.1907514450867052,0.8092485549132948
815,20,21,193,112,81,0.5803108808290155,0.41968911917098445
816,20,22,339,182,157,0.5368731563421829,0.4631268436578171
817,20,23,285,172,113,0.6035087719298246,0.39649122807017545
818,20,24,245,124,121,0.5061224489795918,0.49387755102040815
819,20,25,237,130,107,0.5485232067510548,0.45147679324894513
820,20,26,279,131,148,0.46953405017921146,0.5304659498207885
821,20,27,168,91,77,0.5416666666666666,0.4583333333333333
822,20,28,190,111,79,0.5842105263157895,0.41578947368421054
823,20,29,325,203,122,0.6246153846153846,0.37538461538461537
824,20,30,152,99,53,0.6513157894736842,0.34868421052631576
825,20,31,246,151,95,0.6138211382113821,0.3861788617886179
826,20,32,258,166,92,0.6434108527131783,0.35658914728682173
827,20,33,146,101,45,0.6917808219178082,0.3082191780821918
828,20,34,286,112,174,0.3916083916083916,0.6083916083916084
829,20,35,143,80,63,0.5594405594405595,0.4405594405594406
830,20,36,90,60,30,0.6666666666666666,0.3333333333333333
831,20,37,92,54,38,0.5869565217391305,0.41304347826086957
832,20,38,112,64,48,0.5714285714285714,0.42857142857142855
833,20,39,43,20,23,0.46511627906976744,0.5348837209302325
834,21,1,327,208,119,0.636085626911315,0.363914373088685
835,21,2,201,118,83,0.5870646766169154,0.4129353233830846
836,21,3,305,184,121,0.6032786885245902,0.39672131147540984
837,21,4,283,151,132,0.5335689045936396,0.4664310954063604
838,21,5,335,188,147,0.5611940298507463,0.4388059701492537
839,21,6,257,154,103,0.5992217898832685,0.40077821011673154
840,21,7,328,198,130,0.6036585365853658,0.39634146341463417
841,21,8,270,151,119,0.5592592592592592,0.44074074074074077
842,21,9,334,192,142,0.5748502994011976,0.4251497005988024
843,21,10,281,163,118,0.5800711743772242,0.4199288256227758
844,21,11,284,190,94,0.6690140845070423,0.33098591549295775
845,21,12,270,161,109,0.5962962962962963,0.40370370370370373
846,21,13,260,145,115,0.5576923076923077,0.4423076923076923
847,21,14,349,209,140,0.5988538681948424,0.40114613180515757
848,21,15,261,151,110,0.578544061302682,0.421455938697318
849,21,16,265,164,101,0.6188679245283019,0.38113207547169814
850,21,17,250,137,113,0.548,0.452
851,21,18,327,201,126,0.6146788990825688,0.3853211009174312
852,21,19,303,199,104,0.6567656765676567,0.3432343234323432
853,21,20,279,170,109,0.6093189964157706,0.3906810035842294
854,21,21,233,149,84,0.6394849785407726,0.3605150214592275
855,21,22,281,169,112,0.6014234875444839,0.398576512455516
856,21,23,269,146,123,0.5427509293680297,0.45724907063197023
857,21,24,285,172,113,0.6035087719298246,0.39649122807017545
858,21,25,279,153,126,0.5483870967741935,0.45161290322580644
859,21,26,257,157,100,0.6108949416342413,0.38910505836575876
860,21,27,298,150,148,0.5033557046979866,0.4966442953020134
861,21,28,333,191,142,0.5735735735735735,0.4264264264264264
862,21,29,293,170,123,0.5802047781569966,0.4197952218430034
863,21,30,195,115,80,0.5897435897435898,0.41025641025641024
864,21,31,219,135,84,0.6164383561643836,0.3835616438356164
865,21,32,271,164,107,0.6051660516605166,0.3948339483394834
866,21,33,289,169,120,0.5847750865051903,0.41522491349480967
867,21,34,276,143,133,0.5181159420289855,0.48188405797101447
868,21,35,309,202,107,0.6537216828478964,0.34627831715210355
869,21,36,288,170,118,0.5902777777777778,0.4097222222222222
870,21,37,237,132,105,0.5569620253164557,0.4430379746835443
871,21,38,245,151,94,0.6163265306122448,0.3836734693877551
872,21,39,206,121,85,0.587378640776699,0.41262135922330095
873,21,40,245,161,84,0.6571428571428571,0.34285714285714286
874,21,41,314,175,139,0.5573248407643312,0.4426751592356688
875,21,42,314,190,124,0.6050955414012739,0.39490445859872614
876,21,43,285,177,108,0.6210526315789474,0.37894736842105264
877,21,44,295,165,130,0.559322033898305,0.4406779661016949
878,21,45,289,161,128,0.5570934256055363,0.4429065743944637
879,21,46,325,180,145,0.5538461538461539,0.4461538461538462
880,21,47,252,146,106,0.5793650793650794,0.42063492063492064
881,21,48,265,165,100,0.6226415094339622,0.37735849056603776
882,21,49,330,182,148,0.5515151515151515,0.4484848484848485
883,21,50,245,142,103,0.5795918367346938,0.4204081632653061
884,21,51,326,202,124,0.6196319018404908,0.3803680981595092
885,21,52,300,160,140,0.5333333333333333,0.4666666666666667
886,21,53,225,123,102,0.5466666666666666,0.4533333333333333
887,21,54,230,142,88,0.6173913043478261,0.3826086956521739
888,22,1,175,102,73,0.5828571428571429,0.41714285714285715
889,22,2,333,147,186,0.44144144144144143,0.5585585585585585
890,22,3,436,26,410,0.05963302752293578,0.9403669724770642
891,22,4,274,16,258,0.058394160583941604,0.9416058394160584
892,22,5,320,32,288,0.1,0.9
893,22,6,336,34,302,0.10119047619047619,0.8988095238095238
894,22,7,240,24,216,0.1,0.9
895,22,8,372,175,197,0.47043010752688175,0.5295698924731183
896,22,9,257,12,245,0.04669260700389105,0.953307392996109
897,22,10,436,50,386,0.11467889908256881,0.8853211009174312
898,22,11,264,27,237,0.10227272727272728,0.8977272727272727
899,22,12,293,109,184,0.3720136518771331,0.6279863481228669
900,22,13,315,41,274,0.13015873015873017,0.8698412698412699
901,22,14,229,44,185,0.19213973799126638,0.8078602620087336
902,22,15,234,21,213,0.08974358974358974,0.9102564102564102
903,22,16,286,32,254,0.11188811188811189,0.8881118881118881
904,22,17,333,30,303,0.09009009009009009,0.9099099099099099
905,22,18,249,25,224,0.10040160642570281,0.8995983935742972
906,22,19,124,43,81,0.3467741935483871,0.6532258064516129
907,22,20,305,38,267,0.12459016393442623,0.8754098360655738
908,22,21,300,123,177,0.41,0.59
909,22,22,268,30,238,0.11194029850746269,0.8880597014925373
910,22,23,343,216,127,0.6297376093294461,0.37026239067055394
911,22,24,370,29,341,0.07837837837837838,0.9216216216216216
912,22,25,337,32,305,0.09495548961424333,0.9050445103857567
913,23,1,331,202,129,0.6102719033232629,0.38972809667673713
914,23,2,309,172,137,0.5566343042071198,0.44336569579288027
915,23,3,306,197,109,0.6437908496732027,0.3562091503267974
916,23,4,368,215,153,0.5842391304347826,0.4157608695652174
917,23,5,285,84,201,0.29473684210526313,0.7052631578947368
918,23,6,321,118,203,0.367601246105919,0.632398753894081
919,23,7,263,76,187,0.2889733840304182,0.7110266159695817
920,23,8,362,182,180,0.5027624309392266,0.4972375690607735
921,23,9,240,64,176,0.26666666666666666,0.7333333333333333
922,23,10,337,120,217,0.3560830860534125,0.6439169139465876
923,23,11,325,79,246,0.24307692307692308,0.7569230769230769
924,23,12,336,183,153,0.5446428571428571,0.45535714285714285
925,23,13,193,39,154,0.20207253886010362,0.7979274611398963
926,23,14,297,173,124,0.5824915824915825,0.4175084175084175
927,23,15,258,74,184,0.2868217054263566,0.7131782945736435
928,23,16,313,187,126,0.597444089456869,0.402555910543131
929,23,17,177,37,140,0.20903954802259886,0.7909604519774012
930,23,18,279,132,147,0.4731182795698925,0.5268817204301075
931,23,19,235,50,185,0.2127659574468085,0.7872340425531915
932,23,20,184,45,139,0.24456521739130435,0.7554347826086957
933,23,21,319,191,128,0.5987460815047022,0.4012539184952978
934,23,22,303,170,133,0.5610561056105611,0.4389438943894389
935,23,23,325,180,145,0.5538461538461539,0.4461538461538462
936,23,24,236,54,182,0.2288135593220339,0.7711864406779662
937,23,25,278,96,182,0.34532374100719426,0.6546762589928058
938,23,26,306,130,176,0.42483660130718953,0.5751633986928104
939,23,27,329,186,143,0.5653495440729484,0.43465045592705165
940,23,28,327,167,160,0.5107033639143731,0.4892966360856269
941,23,29,267,149,118,0.5580524344569289,0.4419475655430712
942,23,30,332,99,233,0.29819277108433734,0.7018072289156626
943,23,31,240,50,190,0.20833333333333334,0.7916666666666666
944,23,32,302,93,209,0.3079470198675497,0.6920529801324503
945,23,33,292,60,232,0.2054794520547945,0.7945205479452054
946,23,34,257,68,189,0.26459143968871596,0.7354085603112841
947,23,35,255,130,125,0.5098039215686274,0.49019607843137253
948,23,36,353,226,127,0.6402266288951841,0.3597733711048159
949,23,37,313,201,112,0.6421725239616614,0.35782747603833864
950,23,38,276,155,121,0.5615942028985508,0.4384057971014493
951,23,39,283,71,212,0.2508833922261484,0.7491166077738516
952,24,1,216,113,103,0.5231481481481481,0.47685185185185186
953,24,2,196,101,95,0.5153061224489796,0.4846938775510204
954,24,3,223,125,98,0.5605381165919282,0.43946188340807174
955,24,4,187,114,73,0.6096256684491979,0.39037433155080214
956,24,5,136,66,70,0.4852941176470588,0.5147058823529411
957,24,6,232,120,112,0.5172413793103449,0.4827586206896552
958,24,7,149,41,108,0.2751677852348993,0.7248322147651006
959,24,8,150,79,71,0.5266666666666666,0.47333333333333333
960,24,9,220,124,96,0.5636363636363636,0.43636363636363634
961,24,10,132,58,74,0.4393939393939394,0.5606060606060606
962,24,11,227,121,106,0.5330396475770925,0.4669603524229075
963,24,12,125,73,52,0.584,0.416
964,24,13,116,72,44,0.6206896551724138,0.3793103448275862
965,24,14,193,105,88,0.5440414507772021,0.45595854922279794
966,24,15,139,76,63,0.5467625899280576,0.45323741007194246
967,24,16,263,60,203,0.22813688212927757,0.7718631178707225
968,24,17,158,86,72,0.5443037974683544,0.45569620253164556
969,24,18,252,133,119,0.5277777777777778,0.4722222222222222
970,24,19,247,140,107,0.5668016194331984,0.4331983805668016
971,24,20,172,93,79,0.5406976744186046,0.45930232558139533
972,24,21,113,61,52,0.5398230088495575,0.46017699115044247
973,24,22,279,159,120,0.5698924731182796,0.43010752688172044
974,24,23,201,100,101,0.4975124378109453,0.5024875621890548
975,24,24,274,133,141,0.4854014598540146,0.5145985401459854
976,24,25,188,110,78,0.5851063829787234,0.4148936170212766
977,24,26,320,194,126,0.60625,0.39375
978,24,27,231,126,105,0.5454545454545454,0.45454545454545453
979,24,28,184,91,93,0.4945652173913043,0.5054347826086957
980,24,29,168,99,69,0.5892857142857143,0.4107142857142857
981,24,30,123,65,58,0.5284552845528455,0.4715447154471545
982,24,31,249,127,122,0.5100401606425703,0.4899598393574297
983,24,32,134,81,53,0.6044776119402985,0.39552238805970147
984,24,33,125,72,53,0.576,0.424
985,24,34,200,110,90,0.55,0.45
986,24,35,309,162,147,0.5242718446601942,0.47572815533980584
987,24,36,287,154,133,0.5365853658536586,0.4634146341463415
988,24,37,136,73,63,0.5367647058823529,0.4632352941176471
989,24,38,214,80,134,0.37383177570093457,0.6261682242990654
990,24,39,296,147,149,0.4966216216216216,0.5033783783783784
991,24,40,207,110,97,0.5314009661835749,0.46859903381642515
992,24,41,155,99,56,0.6387096774193548,0.36129032258064514
993,25,1,312,84,228,0.2692307692307692,0.7307692307692307
994,25,2,319,66,253,0.20689655172413793,0.7931034482758621
995,25,3,250,172,78,0.688,0.312
996,25,4,230,142,88,0.6173913043478261,0.3826086956521739
997,25,5,353,101,252,0.28611898016997167,0.7138810198300283
998,25,6,143,103,40,0.7202797202797203,0.27972027972027974
999,25,7,344,52,292,0.1511627906976744,0.8488372093023255
1000,25,8,351,55,296,0.15669515669515668,0.8433048433048433
1001,25,9,343,51,292,0.14868804664723032,0.8513119533527697
1002,25,10,318,276,42,0.8679245283018868,0.1320754716981132
1003,25,11,352,67,285,0.1903409090909091,0.8096590909090909
1004,25,12,326,70,256,0.2147239263803681,0.7852760736196319
1005,25,13,379,55,324,0.14511873350923482,0.8548812664907651
1006,25,14,249,181,68,0.7269076305220884,0.27309236947791166
1007,25,15,323,88,235,0.2724458204334365,0.7275541795665634
1008,25,16,301,256,45,0.8504983388704319,0.14950166112956811
1009,25,17,378,95,283,0.25132275132275134,0.7486772486772487
1010,25,18,333,266,67,0.7987987987987988,0.2012012012012012
1011,25,19,389,65,324,0.16709511568123395,0.8329048843187661
1012,25,20,213,138,75,0.647887323943662,0.352112676056338
1013,25,21,316,233,83,0.7373417721518988,0.2626582278481013
1014,25,22,326,59,267,0.18098159509202455,0.8190184049079755
1015,25,23,360,74,286,0.20555555555555555,0.7944444444444444
1016,25,24,359,55,304,0.1532033426183844,0.8467966573816156
1017,25,25,309,209,100,0.6763754045307443,0.32362459546925565
1018,25,26,318,59,259,0.18553459119496854,0.8144654088050315
1019,25,27,220,150,70,0.6818181818181818,0.3181818181818182
1020,25,28,368,62,306,0.16847826086956522,0.8315217391304348
1021,25,29,272,163,109,0.5992647058823529,0.4007352941176471
1022,25,30,309,51,258,0.1650485436893204,0.8349514563106796
1023,25,31,312,258,54,0.8269230769230769,0.17307692307692307
1024,25,32,299,83,216,0.27759197324414714,0.7224080267558528
1025,26,1,197,82,115,0.41624365482233505,0.583756345177665
1026,26,2,211,55,156,0.26066350710900477,0.7393364928909952
1027,26,3,212,95,117,0.4481132075471698,0.5518867924528302
1028,26,4,168,60,108,0.35714285714285715,0.6428571428571429
1029,26,5,193,58,135,0.3005181347150259,0.6994818652849741
1030,26,6,230,72,158,0.3130434782608696,0.6869565217391305
1031,26,7,161,49,112,0.30434782608695654,0.6956521739130435
1032,26,8,115,26,89,0.22608695652173913,0.7739130434782608
1033,26,9,197,60,137,0.30456852791878175,0.6954314720812182
1034,26,10,196,59,137,0.3010204081632653,0.6989795918367347
1035,26,11,205,59,146,0.28780487804878047,0.7121951219512195
1036,26,12,190,74,116,0.3894736842105263,0.6105263157894737
1037,26,13,140,52,88,0.37142857142857144,0.6285714285714286
1038,26,14,154,34,120,0.22077922077922077,0.7792207792207793
1039,26,15,125,43,82,0.344,0.656
1040,26,16,125,39,86,0.312,0.688
1041,26,17,205,116,89,0.5658536585365853,0.43414634146341463
1042,26,18,201,80,121,0.39800995024875624,0.6019900497512438
1043,26,19,131,43,88,0.3282442748091603,0.6717557251908397
1044,26,20,191,84,107,0.4397905759162304,0.5602094240837696
1045,26,21,220,73,147,0.33181818181818185,0.6681818181818182
1046,26,22,146,41,105,0.2808219178082192,0.7191780821917808
1047,26,23,142,44,98,0.30985915492957744,0.6901408450704225
1048,26,24,199,67,132,0.33668341708542715,0.6633165829145728
1049,26,25,191,55,136,0.2879581151832461,0.7120418848167539
1050,26,26,131,43,88,0.3282442748091603,0.6717557251908397
1051,26,27,240,89,151,0.37083333333333335,0.6291666666666667
1052,26,28,235,127,108,0.5404255319148936,0.4595744680851064
1053,26,29,146,53,93,0.363013698630137,0.636986301369863
1054,26,30,158,48,110,0.3037974683544304,0.6962025316455697
1055,26,31,118,34,84,0.288135593220339,0.711864406779661
1056,26,32,217,115,102,0.5299539170506913,0.4700460829493088
1057,26,33,201,72,129,0.3582089552238806,0.6417910447761194
1058,26,34,228,81,147,0.35526315789473684,0.6447368421052632
1059,26,35,220,84,136,0.38181818181818183,0.6181818181818182
1060,26,36,164,57,107,0.3475609756097561,0.6524390243902439
1061,26,37,207,54,153,0.2608695652173913,0.7391304347826086
1062,26,38,126,39,87,0.30952380952380953,0.6904761904761905
1063,26,39,213,79,134,0.37089201877934275,0.6291079812206573
1064,26,40,98,32,66,0.32653061224489793,0.673469387755102
1065,26,41,218,81,137,0.37155963302752293,0.6284403669724771
1066,26,42,170,48,122,0.2823529411764706,0.7176470588235294
1067,26,43,145,38,107,0.2620689655172414,0.7379310344827587
1068,26,44,127,41,86,0.3228346456692913,0.6771653543307087
1069,26,45,99,30,69,0.30303030303030304,0.696969696969697
1070,26,46,135,66,69,0.4888888888888889,0.5111111111111111
1071,26,47,173,41,132,0.23699421965317918,0.7630057803468208
1072,26,48,172,59,113,0.3430232558139535,0.6569767441860465
1073,26,49,124,31,93,0.25,0.75
1074,27,1,249,203,46,0.8152610441767069,0.18473895582329317
1075,27,2,295,207,88,0.7016949152542373,0.2983050847457627
1076,27,3,146,75,71,0.5136986301369864,0.4863013698630137
1077,27,4,145,75,70,0.5172413793103449,0.4827586206896552
1078,27,5,178,102,76,0.5730337078651685,0.42696629213483145
1079,27,6,195,132,63,0.676923076923077,0.3230769230769231
1080,27,7,296,149,147,0.5033783783783784,0.4966216216216216
1081,27,8,185,110,75,0.5945945945945946,0.40540540540540543
1082,27,9,108,87,21,0.8055555555555556,0.19444444444444445
1083,27,10,266,176,90,0.6616541353383458,0.3383458646616541
1084,27,11,230,173,57,0.7521739130434782,0.24782608695652175
1085,27,12,177,144,33,0.8135593220338984,0.1864406779661017
1086,27,13,371,221,150,0.5956873315363881,0.40431266846361186
1087,27,14,119,73,46,0.6134453781512605,0.3865546218487395
1088,27,15,169,117,52,0.6923076923076923,0.3076923076923077
1089,27,16,181,137,44,0.7569060773480663,0.2430939226519337
1090,27,17,226,135,91,0.5973451327433629,0.4026548672566372
1091,27,18,193,126,67,0.6528497409326425,0.3471502590673575
1092,27,19,160,89,71,0.55625,0.44375
1093,27,20,175,108,67,0.6171428571428571,0.38285714285714284
1094,27,21,245,205,40,0.8367346938775511,0.16326530612244897
1095,27,22,152,74,78,0.4868421052631579,0.5131578947368421
1096,27,23,210,126,84,0.6,0.4
1097,27,24,199,79,120,0.3969849246231156,0.6030150753768844
1098,27,25,194,117,77,0.6030927835051546,0.39690721649484534
1099,27,26,215,111,104,0.5162790697674419,0.48372093023255813
1100,27,27,230,150,80,0.6521739130434783,0.34782608695652173
1101,27,28,125,72,53,0.576,0.424
1102,27,29,180,74,106,0.4111111111111111,0.5888888888888889
1103,27,30,125,71,54,0.568,0.432
1104,27,31,186,106,80,0.5698924731182796,0.43010752688172044
1105,27,32,192,102,90,0.53125,0.46875
1106,27,33,233,162,71,0.6952789699570815,0.30472103004291845
1107,27,34,233,162,71,0.6952789699570815,0.30472103004291845
1108,27,35,239,172,67,0.7196652719665272,0.2803347280334728
1109,27,36,177,98,79,0.5536723163841808,0.4463276836158192
1110,27,37,295,216,79,0.7322033898305085,0.2677966101694915
1111,27,38,417,310,107,0.7434052757793765,0.2565947242206235
1112,27,39,199,115,84,0.5778894472361809,0.4221105527638191
1113,27,40,297,178,119,0.5993265993265994,0.4006734006734007
1114,27,41,251,171,80,0.6812749003984063,0.3187250996015936
1115,27,42,177,121,56,0.6836158192090396,0.3163841807909605
1116,27,43,177,93,84,0.5254237288135594,0.4745762711864407
1117,27,44,186,104,82,0.5591397849462365,0.44086021505376344
1118,27,45,264,182,82,0.6893939393939394,0.3106060606060606
1119,27,46,187,168,19,0.8983957219251337,0.10160427807486631
1120,27,47,217,139,78,0.6405529953917051,0.35944700460829493
1121,27,48,272,175,97,0.6433823529411765,0.35661764705882354
1122,27,49,149,85,64,0.5704697986577181,0.42953020134228187
1123,27,50,206,128,78,0.6213592233009708,0.3786407766990291
1124,28,1,180,99,81,0.55,0.45
1125,28,2,179,94,85,0.5251396648044693,0.4748603351955307
1126,28,3,151,72,79,0.4768211920529801,0.5231788079470199
1127,28,4,183,114,69,0.6229508196721312,0.3770491803278688
1128,28,5,167,101,66,0.6047904191616766,0.39520958083832336
1129,28,6,153,102,51,0.6666666666666666,0.3333333333333333
1130,28,7,220,122,98,0.5545454545454546,0.44545454545454544
1131,28,8,131,94,37,0.7175572519083969,0.2824427480916031
1132,28,9,199,126,73,0.6331658291457286,0.36683417085427134
1133,28,10,235,150,85,0.6382978723404256,0.3617021276595745
1134,28,11,361,157,204,0.43490304709141275,0.5650969529085873
1135,28,12,222,143,79,0.6441441441441441,0.35585585585585583
1136,28,13,199,109,90,0.5477386934673367,0.45226130653266333
1137,28,14,218,141,77,0.6467889908256881,0.3532110091743119
1138,28,15,81,58,23,0.7160493827160493,0.2839506172839506
1139,28,16,140,87,53,0.6214285714285714,0.37857142857142856
1140,28,17,171,108,63,0.631578947368421,0.3684210526315789
1141,28,18,182,117,65,0.6428571428571429,0.35714285714285715
1142,28,19,212,82,130,0.3867924528301887,0.6132075471698113
1143,28,20,223,108,115,0.484304932735426,0.515695067264574
1144,28,21,185,116,69,0.6270270270270271,0.372972972972973
1145,28,22,180,85,95,0.4722222222222222,0.5277777777777778
1146,28,23,245,141,104,0.5755102040816327,0.42448979591836733
1147,28,24,192,110,82,0.5729166666666666,0.4270833333333333
1148,28,25,273,134,139,0.4908424908424908,0.5091575091575091
1149,28,26,222,135,87,0.6081081081081081,0.3918918918918919
1150,28,27,243,151,92,0.6213991769547325,0.3786008230452675
1151,28,28,268,177,91,0.6604477611940298,0.33955223880597013
1152,28,29,93,55,38,0.5913978494623656,0.40860215053763443
1153,28,30,47,27,20,0.574468085106383,0.425531914893617
1154,28,31,318,208,110,0.6540880503144654,0.34591194968553457
1155,28,32,195,117,78,0.6,0.4
1156,28,33,243,146,97,0.6008230452674898,0.3991769547325103
1157,28,34,286,157,129,0.548951048951049,0.45104895104895104
1158,28,35,233,117,116,0.5021459227467812,0.4978540772532189
1159,28,36,142,81,61,0.5704225352112676,0.4295774647887324
1160,28,37,293,186,107,0.6348122866894198,0.3651877133105802
1161,28,38,115,64,51,0.5565217391304348,0.4434782608695652
1162,28,39,167,102,65,0.6107784431137725,0.38922155688622756
1163,28,40,262,164,98,0.6259541984732825,0.37404580152671757
1164,28,41,165,85,80,0.5151515151515151,0.48484848484848486
1165,28,42,242,131,111,0.5413223140495868,0.45867768595041325
1166,28,43,255,170,85,0.6666666666666666,0.3333333333333333
1167,28,44,159,84,75,0.5283018867924528,0.4716981132075472
1168,28,45,177,118,59,0.6666666666666666,0.3333333333333333
1169,28,46,404,171,233,0.42326732673267325,0.5767326732673267
1170,29,1,397,217,180,0.5465994962216625,0.4534005037783375
1171,29,2,406,257,149,0.6330049261083743,0.3669950738916256
1172,29,3,301,200,101,0.6644518272425249,0.33554817275747506
1173,29,4,320,195,125,0.609375,0.390625
1174,29,5,253,143,110,0.5652173913043478,0.43478260869565216
1175,29,6,234,138,96,0.5897435897435898,0.41025641025641024
1176,29,7,300,189,111,0.63,0.37
1177,29,8,171,98,73,0.5730994152046783,0.4269005847953216
1178,29,9,375,191,184,0.5093333333333333,0.49066666666666664
1179,29,10,448,263,185,0.5870535714285714,0.41294642857142855
1180,29,11,175,89,86,0.5085714285714286,0.49142857142857144
1181,29,12,359,216,143,0.6016713091922006,0.3983286908077994
1182,29,13,298,169,129,0.5671140939597316,0.43288590604026844
1183,29,14,303,155,148,0.5115511551155115,0.4884488448844885
1184,29,15,361,217,144,0.6011080332409973,0.3988919667590028
1185,29,16,299,177,122,0.5919732441471572,0.4080267558528428
1186,29,17,272,176,96,0.6470588235294118,0.35294117647058826
1187,29,18,263,162,101,0.6159695817490495,0.3840304182509506
1188,29,19,314,165,149,0.5254777070063694,0.4745222929936306
1189,29,20,385,216,169,0.561038961038961,0.43896103896103894
1190,29,21,288,181,107,0.6284722222222222,0.3715277777777778
1191,29,22,218,99,119,0.4541284403669725,0.5458715596330275
1192,29,23,331,161,170,0.486404833836858,0.513595166163142
1193,29,24,259,165,94,0.637065637065637,0.36293436293436293
1194,29,25,342,228,114,0.6666666666666666,0.3333333333333333
1195,29,26,302,172,130,0.5695364238410596,0.4304635761589404
1196,29,27,255,146,109,0.5725490196078431,0.42745098039215684
1197,29,28,356,194,162,0.5449438202247191,0.4550561797752809
1198,29,29,297,165,132,0.5555555555555556,0.4444444444444444
1199,29,30,393,227,166,0.5776081424936387,0.4223918575063613
1200,29,31,286,164,122,0.5734265734265734,0.42657342657342656
1201,29,32,267,131,136,0.49063670411985016,0.5093632958801498
1202,29,33,250,141,109,0.564,0.436
1203,29,34,200,112,88,0.56,0.44
1204,29,35,183,101,82,0.5519125683060109,0.44808743169398907
1205,29,36,274,186,88,0.6788321167883211,0.32116788321167883
1206,29,37,281,156,125,0.5551601423487544,0.44483985765124556
1207,29,38,258,123,135,0.47674418604651164,0.5232558139534884
1208,29,39,282,142,140,0.5035460992907801,0.49645390070921985
1209,29,40,331,201,130,0.6072507552870091,0.39274924471299094
1210,29,41,249,153,96,0.6144578313253012,0.3855421686746988
1211,29,42,283,171,112,0.6042402826855123,0.3957597173144876
1212,29,43,390,195,195,0.5,0.5
1213,29,44,367,199,168,0.5422343324250681,0.45776566757493187
1214,30,1,283,119,164,0.4204946996466431,0.5795053003533569
1215,30,2,276,127,149,0.4601449275362319,0.5398550724637681
1216,30,3,211,93,118,0.44075829383886256,0.5592417061611374
1217,30,4,282,134,148,0.475177304964539,0.524822695035461
1218,30,5,200,71,129,0.355,0.645
1219,30,6,228,99,129,0.4342105263157895,0.5657894736842105
1220,30,7,297,101,196,0.3400673400673401,0.6599326599326599
1221,30,8,312,147,165,0.47115384615384615,0.5288461538461539
1222,30,9,224,113,111,0.5044642857142857,0.4955357142857143
1223,30,10,279,112,167,0.4014336917562724,0.5985663082437276
1224,30,11,219,66,153,0.3013698630136986,0.6986301369863014
1225,30,12,234,95,139,0.405982905982906,0.594017094017094
1226,30,13,252,112,140,0.4444444444444444,0.5555555555555556
1227,30,14,172,63,109,0.36627906976744184,0.6337209302325582
1228,30,15,289,178,111,0.615916955017301,0.38408304498269896
1229,30,16,140,56,84,0.4,0.6
1230,30,17,271,141,130,0.5202952029520295,0.4797047970479705
1231,30,18,254,73,181,0.2874015748031496,0.7125984251968503
1232,30,19,251,60,191,0.23904382470119523,0.7609561752988048
1233,30,20,285,105,180,0.3684210526315789,0.631578947368421
1234,30,21,240,106,134,0.44166666666666665,0.5583333333333333
1235,30,22,287,88,199,0.30662020905923343,0.6933797909407665
1236,30,23,238,82,156,0.3445378151260504,0.6554621848739496
1237,30,24,240,81,159,0.3375,0.6625
1238,30,25,271,106,165,0.39114391143911437,0.6088560885608856
1239,30,26,175,77,98,0.44,0.56
1240,30,27,157,74,83,0.4713375796178344,0.5286624203821656
1241,30,28,280,132,148,0.4714285714285714,0.5285714285714286
1242,30,29,148,53,95,0.3581081081081081,0.6418918918918919
1243,30,30,114,37,77,0.32456140350877194,0.6754385964912281
1244,30,31,191,86,105,0.450261780104712,0.5497382198952879
1245,30,32,190,80,110,0.42105263157894735,0.5789473684210527
1246,31,1,208,57,151,0.27403846153846156,0.7259615384615384
1247,31,2,175,59,116,0.33714285714285713,0.6628571428571428
1248,31,3,237,99,138,0.4177215189873418,0.5822784810126582
1249,31,4,236,78,158,0.3305084745762712,0.6694915254237288
1250,31,5,224,82,142,0.36607142857142855,0.6339285714285714
1251,31,6,214,87,127,0.40654205607476634,0.5934579439252337
1252,31,7,223,78,145,0.34977578475336324,0.6502242152466368
1253,31,8,151,60,91,0.3973509933774834,0.6026490066225165
1254,31,9,248,95,153,0.38306451612903225,0.6169354838709677
1255,31,10,181,77,104,0.425414364640884,0.574585635359116
1256,31,11,186,86,100,0.46236559139784944,0.5376344086021505
1257,31,12,183,80,103,0.4371584699453552,0.5628415300546448
1258,31,13,231,59,172,0.2554112554112554,0.7445887445887446
1259,31,14,203,90,113,0.4433497536945813,0.5566502463054187
1260,31,15,178,68,110,0.38202247191011235,0.6179775280898876
1261,31,16,246,60,186,0.24390243902439024,0.7560975609756098
1262,31,17,221,102,119,0.46153846153846156,0.5384615384615384
1263,31,18,203,84,119,0.41379310344827586,0.5862068965517241
1264,31,19,188,85,103,0.4521276595744681,0.5478723404255319
1265,31,20,203,73,130,0.35960591133004927,0.6403940886699507
1266,31,21,187,77,110,0.4117647058823529,0.5882352941176471
1267,31,22,176,43,133,0.24431818181818182,0.7556818181818182
1268,31,23,194,80,114,0.41237113402061853,0.5876288659793815
1269,31,24,228,93,135,0.40789473684210525,0.5921052631578947
1270,31,25,187,64,123,0.3422459893048128,0.6577540106951871
1271,31,26,230,97,133,0.4217391304347826,0.5782608695652174
1272,31,27,250,104,146,0.416,0.584
1273,31,28,178,62,116,0.34831460674157305,0.651685393258427
1274,31,29,248,122,126,0.49193548387096775,0.5080645161290323
1275,31,30,168,64,104,0.38095238095238093,0.6190476190476191
1276,31,31,209,78,131,0.37320574162679426,0.6267942583732058
1277,31,32,174,55,119,0.3160919540229885,0.6839080459770115
1278,31,33,200,95,105,0.475,0.525
1279,31,34,204,91,113,0.44607843137254904,0.553921568627451
1280,31,35,245,84,161,0.34285714285714286,0.6571428571428571
1281,31,36,245,101,144,0.4122448979591837,0.5877551020408164
1282,31,37,188,76,112,0.40425531914893614,0.5957446808510638
1283,31,38,210,79,131,0.3761904761904762,0.6238095238095238
1284,31,39,193,48,145,0.24870466321243523,0.7512953367875648
1285,31,40,209,71,138,0.3397129186602871,0.6602870813397129
1286,31,41,195,49,146,0.2512820512820513,0.7487179487179487
1287,32,1,282,172,110,0.6099290780141844,0.3900709219858156
1288,32,2,249,188,61,0.7550200803212851,0.24497991967871485
1289,32,3,358,139,219,0.388268156424581,0.611731843575419
1290,32,4,299,208,91,0.6956521739130435,0.30434782608695654
1291,32,5,287,172,115,0.5993031358885017,0.40069686411149824
1292,32,6,258,203,55,0.7868217054263565,0.2131782945736434
1293,32,7,315,234,81,0.7428571428571429,0.2571428571428571
1294,32,8,322,270,52,0.8385093167701864,0.16149068322981366
1295,32,9,301,188,113,0.6245847176079734,0.3754152823920266
1296,32,10,287,206,81,0.7177700348432056,0.28222996515679444
1297,32,11,301,117,184,0.38870431893687707,0.6112956810631229
1298,32,12,267,81,186,0.30337078651685395,0.6966292134831461
1299,32,13,282,223,59,0.7907801418439716,0.20921985815602837
1300,32,14,274,107,167,0.3905109489051095,0.6094890510948905
1301,32,15,264,164,100,0.6212121212121212,0.3787878787878788
1302,32,16,289,156,133,0.5397923875432526,0.4602076124567474
1303,32,17,316,131,185,0.41455696202531644,0.5854430379746836
1304,32,18,300,250,50,0.8333333333333334,0.16666666666666666
1305,32,19,253,138,115,0.5454545454545454,0.45454545454545453
1306,32,20,324,78,246,0.24074074074074073,0.7592592592592593
1307,32,21,331,216,115,0.6525679758308157,0.3474320241691843
1308,32,22,360,146,214,0.40555555555555556,0.5944444444444444
1309,32,23,256,201,55,0.78515625,0.21484375
1310,32,24,196,167,29,0.8520408163265306,0.14795918367346939
1311,32,25,261,162,99,0.6206896551724138,0.3793103448275862
1312,32,26,340,158,182,0.4647058823529412,0.5352941176470588
1313,32,27,321,253,68,0.7881619937694704,0.2118380062305296
1314,32,28,301,123,178,0.40863787375415284,0.5913621262458472
1315,32,29,316,170,146,0.5379746835443038,0.4620253164556962
1316,32,30,290,248,42,0.8551724137931035,0.14482758620689656
1317,32,31,295,213,82,0.7220338983050848,0.27796610169491526
1318,32,32,299,211,88,0.705685618729097,0.29431438127090304
1319,32,33,319,216,103,0.677115987460815,0.322884012539185
1320,32,34,262,154,108,0.5877862595419847,0.4122137404580153
1321,32,35,258,183,75,0.7093023255813954,0.29069767441860467
1322,32,36,287,209,78,0.7282229965156795,0.27177700348432055
1323,32,37,222,122,100,0.5495495495495496,0.45045045045045046
1324,32,38,254,165,89,0.6496062992125984,0.35039370078740156
1325,32,39,348,295,53,0.8477011494252874,0.15229885057471265
1326,32,40,338,263,75,0.7781065088757396,0.22189349112426035
1327,32,41,297,222,75,0.7474747474747475,0.25252525252525254
1328,32,42,264,169,95,0.6401515151515151,0.35984848484848486
1329,32,43,286,117,169,0.4090909090909091,0.5909090909090909
1330,33,1,325,122,203,0.37538461538461537,0.6246153846153846
1331,33,2,416,172,244,0.41346153846153844,0.5865384615384616
1332,33,3,374,142,232,0.37967914438502676,0.6203208556149733
1333,33,4,370,149,221,0.4027027027027027,0.5972972972972973
1334,33,5,285,139,146,0.48771929824561405,0.512280701754386
1335,33,6,300,130,170,0.43333333333333335,0.5666666666666667
1336,33,7,349,173,176,0.49570200573065903,0.504297994269341
1337,33,8,478,256,222,0.5355648535564853,0.46443514644351463
1338,33,9,351,185,166,0.5270655270655271,0.47293447293447294
1339,33,10,365,218,147,0.5972602739726027,0.40273972602739727
1340,33,11,348,145,203,0.4166666666666667,0.5833333333333334
1341,33,12,344,159,185,0.4622093023255814,0.5377906976744186
1342,33,13,310,98,212,0.3161290322580645,0.6838709677419355
1343,33,14,159,45,114,0.2830188679245283,0.7169811320754716
1344,33,15,407,149,258,0.36609336609336607,0.6339066339066339
1345,33,16,487,233,254,0.4784394250513347,0.5215605749486653
1346,33,17,395,161,234,0.40759493670886077,0.5924050632911393
1347,33,18,396,151,245,0.3813131313131313,0.6186868686868687
1348,33,19,301,130,171,0.4318936877076412,0.5681063122923588
1349,33,20,377,153,224,0.40583554376657827,0.5941644562334217
1350,33,21,351,151,200,0.4301994301994302,0.5698005698005698
1351,33,22,387,211,176,0.5452196382428941,0.45478036175710596
1352,33,23,355,175,180,0.49295774647887325,0.5070422535211268
1353,33,24,545,326,219,0.5981651376146789,0.4018348623853211
1354,33,25,407,158,249,0.3882063882063882,0.6117936117936118
1355,33,26,230,78,152,0.3391304347826087,0.6608695652173913
1356,33,27,264,115,149,0.4356060606060606,0.5643939393939394
1357,33,28,261,88,173,0.3371647509578544,0.6628352490421456
1358,34,1,318,189,129,0.5943396226415094,0.4056603773584906
1359,34,2,270,175,95,0.6481481481481481,0.35185185185185186
1360,34,3,297,182,115,0.6127946127946128,0.3872053872053872
1361,34,4,222,132,90,0.5945945945945946,0.40540540540540543
1362,34,5,253,162,91,0.6403162055335968,0.35968379446640314
1363,34,6,350,227,123,0.6485714285714286,0.3514285714285714
1364,34,7,322,206,116,0.639751552795031,0.36024844720496896
1365,34,8,219,122,97,0.5570776255707762,0.4429223744292237
1366,34,9,226,126,100,0.5575221238938053,0.4424778761061947
1367,34,10,301,171,130,0.5681063122923588,0.4318936877076412
1368,34,11,223,138,85,0.6188340807174888,0.3811659192825112
1369,34,12,312,194,118,0.6217948717948718,0.3782051282051282
1370,34,13,298,172,126,0.5771812080536913,0.4228187919463087
1371,34,14,220,125,95,0.5681818181818182,0.4318181818181818
1372,34,15,202,124,78,0.6138613861386139,0.38613861386138615
1373,34,16,228,140,88,0.6140350877192983,0.38596491228070173
1374,34,17,350,221,129,0.6314285714285715,0.36857142857142855
1375,34,18,204,121,83,0.5931372549019608,0.4068627450980392
1376,34,19,274,169,105,0.6167883211678832,0.38321167883211676
1377,34,20,360,251,109,0.6972222222222222,0.30277777777777776
1378,34,21,375,251,124,0.6693333333333333,0.33066666666666666
1379,34,22,290,194,96,0.6689655172413793,0.3310344827586207
1380,34,23,236,146,90,0.6186440677966102,0.3813559322033898
1381,34,24,235,145,90,0.6170212765957447,0.3829787234042553
1382,34,25,339,232,107,0.6843657817109144,0.31563421828908556
1383,34,26,290,169,121,0.5827586206896552,0.41724137931034483
1384,34,27,231,136,95,0.5887445887445888,0.41125541125541126
1385,34,28,187,119,68,0.6363636363636364,0.36363636363636365
1386,34,29,220,121,99,0.55,0.45
1387,34,30,304,176,128,0.5789473684210527,0.42105263157894735
1388,34,31,219,149,70,0.680365296803653,0.319634703196347
1389,34,32,264,177,87,0.6704545454545454,0.32954545454545453
1390,34,33,223,127,96,0.5695067264573991,0.4304932735426009
1391,34,34,301,173,128,0.574750830564784,0.42524916943521596
1392,34,35,292,169,123,0.5787671232876712,0.4212328767123288
1393,34,36,275,153,122,0.5563636363636364,0.44363636363636366
1394,34,37,165,99,66,0.6,0.4
1395,34,38,167,111,56,0.6646706586826348,0.33532934131736525
1396,34,39,221,122,99,0.5520361990950227,0.4479638009049774
1397,34,40,305,183,122,0.6,0.4
1398,34,41,200,118,82,0.59,0.41
1399,34,42,315,191,124,0.6063492063492063,0.39365079365079364
1400,34,43,286,170,116,0.5944055944055944,0.40559440559440557
1401,34,44,280,177,103,0.6321428571428571,0.3678571428571429
1402,34,45,311,200,111,0.6430868167202572,0.35691318327974275
1403,34,46,190,116,74,0.6105263157894737,0.3894736842105263
1404,34,47,235,173,62,0.7361702127659574,0.26382978723404255
1405,34,48,325,199,126,0.6123076923076923,0.38769230769230767
1406,34,49,355,201,154,0.5661971830985916,0.43380281690140843
1407,34,50,224,124,100,0.5535714285714286,0.44642857142857145
1408,34,51,317,184,133,0.580441640378549,0.4195583596214511
1409,34,52,231,147,84,0.6363636363636364,0.36363636363636365
1410,34,53,180,117,63,0.65,0.35
1411,35,1,293,99,194,0.3378839590443686,0.6621160409556314
1412,35,2,349,131,218,0.3753581661891118,0.6246418338108882
1413,35,3,237,75,162,0.31645569620253167,0.6835443037974683
1414,35,4,311,132,179,0.42443729903536975,0.5755627009646302
1415,35,5,256,74,182,0.2890625,0.7109375
1416,35,6,254,81,173,0.3188976377952756,0.6811023622047244
1417,35,7,257,56,201,0.2178988326848249,0.7821011673151751
1418,35,8,242,59,183,0.24380165289256198,0.756198347107438
1419,35,9,302,122,180,0.40397350993377484,0.5960264900662252
1420,35,10,334,107,227,0.3203592814371258,0.6796407185628742
1421,35,11,307,91,216,0.2964169381107492,0.7035830618892508
1422,35,12,194,44,150,0.2268041237113402,0.7731958762886598
1423,35,13,191,45,146,0.2356020942408377,0.7643979057591623
1424,35,14,225,62,163,0.27555555555555555,0.7244444444444444
1425,35,15,322,76,246,0.2360248447204969,0.7639751552795031
1426,35,16,197,47,150,0.23857868020304568,0.7614213197969543
1427,35,17,270,118,152,0.43703703703703706,0.562962962962963
1428,35,18,239,77,162,0.32217573221757323,0.6778242677824268
1429,35,19,179,51,128,0.2849162011173184,0.7150837988826816
1430,35,20,220,78,142,0.35454545454545455,0.6454545454545455
1431,35,21,244,78,166,0.319672131147541,0.680327868852459
1432,35,22,292,123,169,0.4212328767123288,0.5787671232876712
1433,35,23,272,118,154,0.4338235294117647,0.5661764705882353
1434,35,24,251,81,170,0.32270916334661354,0.6772908366533864
1435,35,25,284,112,172,0.39436619718309857,0.6056338028169014
1436,35,26,235,94,141,0.4,0.6
1437,35,27,230,97,133,0.4217391304347826,0.5782608695652174
1438,35,28,272,98,174,0.3602941176470588,0.6397058823529411
1439,35,29,218,80,138,0.3669724770642202,0.6330275229357798
1440,35,30,273,124,149,0.4542124542124542,0.5457875457875457
1441,35,31,321,139,182,0.43302180685358255,0.5669781931464174
1442,36,1,278,126,152,0.45323741007194246,0.5467625899280576
1443,36,2,293,92,201,0.31399317406143346,0.6860068259385665
1444,36,3,289,102,187,0.35294117647058826,0.6470588235294118
1445,36,4,289,109,180,0.3771626297577855,0.6228373702422145
1446,36,5,293,108,185,0.36860068259385664,0.6313993174061433
1447,36,6,239,88,151,0.3682008368200837,0.6317991631799164
1448,36,7,384,227,157,0.5911458333333334,0.4088541666666667
1449,36,8,247,51,196,0.20647773279352227,0.7935222672064778
1450,36,9,249,66,183,0.26506024096385544,0.7349397590361446
1451,36,10,297,98,199,0.32996632996632996,0.67003367003367
1452,36,11,214,82,132,0.38317757009345793,0.616822429906542
1453,36,12,167,46,121,0.2754491017964072,0.7245508982035929
1454,36,13,194,49,145,0.25257731958762886,0.7474226804123711
1455,36,14,300,145,155,0.48333333333333334,0.5166666666666667
1456,36,15,337,180,157,0.5341246290801187,0.4658753709198813
1457,36,16,318,154,164,0.48427672955974843,0.5157232704402516
1458,36,17,343,181,162,0.5276967930029155,0.47230320699708456
1459,36,18,309,175,134,0.5663430420711975,0.4336569579288026
1460,36,19,318,135,183,0.42452830188679247,0.5754716981132075
1461,36,20,284,139,145,0.4894366197183099,0.5105633802816901
1462,36,21,230,75,155,0.32608695652173914,0.6739130434782609
1463,36,22,217,46,171,0.2119815668202765,0.7880184331797235
1464,36,23,243,73,170,0.3004115226337449,0.6995884773662552
1465,36,24,338,170,168,0.5029585798816568,0.4970414201183432
1466,36,25,242,64,178,0.2644628099173554,0.7355371900826446
1467,36,26,270,170,100,0.6296296296296297,0.37037037037037035
1468,36,27,272,117,155,0.43014705882352944,0.5698529411764706
1469,36,28,265,127,138,0.47924528301886793,0.5207547169811321
1470,36,29,361,181,180,0.5013850415512465,0.4986149584487535
1471,36,30,318,175,143,0.550314465408805,0.449685534591195
1472,37,1,229,154,75,0.6724890829694323,0.32751091703056767
1473,37,2,176,73,103,0.4147727272727273,0.5852272727272727
1474,37,3,168,103,65,0.6130952380952381,0.3869047619047619
1475,37,4,220,131,89,0.5954545454545455,0.40454545454545454
1476,37,5,296,188,108,0.6351351351351351,0.36486486486486486
1477,37,6,265,154,111,0.5811320754716981,0.4188679245283019
1478,37,7,192,102,90,0.53125,0.46875
1479,37,8,193,98,95,0.5077720207253886,0.49222797927461137
1480,37,9,248,150,98,0.6048387096774194,0.3951612903225806
1481,37,10,315,171,144,0.5428571428571428,0.45714285714285713
1482,37,11,173,115,58,0.6647398843930635,0.3352601156069364
1483,37,12,191,91,100,0.47643979057591623,0.5235602094240838
1484,37,13,192,115,77,0.5989583333333334,0.4010416666666667
1485,37,14,265,172,93,0.6490566037735849,0.35094339622641507
1486,37,15,287,191,96,0.6655052264808362,0.3344947735191638
1487,37,16,268,152,116,0.5671641791044776,0.43283582089552236
1488,37,17,216,150,66,0.6944444444444444,0.3055555555555556
1489,37,18,264,150,114,0.5681818181818182,0.4318181818181818
1490,37,19,189,85,104,0.4497354497354497,0.5502645502645502
1491,37,20,209,119,90,0.569377990430622,0.430622009569378
1492,37,21,240,133,107,0.5541666666666667,0.44583333333333336
1493,37,22,240,111,129,0.4625,0.5375
1494,37,23,271,167,104,0.6162361623616236,0.3837638376383764
1495,37,24,279,178,101,0.6379928315412187,0.36200716845878134
1496,37,25,257,159,98,0.6186770428015564,0.38132295719844356
1497,37,26,337,203,134,0.6023738872403561,0.39762611275964393
1498,37,27,270,146,124,0.5407407407407407,0.45925925925925926
1499,37,28,206,109,97,0.529126213592233,0.470873786407767
1500,37,29,279,151,128,0.5412186379928315,0.45878136200716846
1501,37,30,241,128,113,0.5311203319502075,0.46887966804979253
1502,37,31,292,172,120,0.589041095890411,0.410958904109589
1503,37,32,250,138,112,0.552,0.448
1504,37,33,273,165,108,0.6043956043956044,0.3956043956043956
1505,37,34,259,165,94,0.637065637065637,0.36293436293436293
1506,37,35,279,187,92,0.6702508960573477,0.32974910394265233
1507,37,36,213,142,71,0.6666666666666666,0.3333333333333333
1508,37,37,267,169,98,0.6329588014981273,0.36704119850187267
1509,37,38,304,164,140,0.5394736842105263,0.4605263157894737
1510,37,39,229,124,105,0.5414847161572053,0.4585152838427948
1511,37,40,295,185,110,0.6271186440677966,0.3728813559322034
1512,37,41,323,183,140,0.56656346749226,0.43343653250773995
1513,38,1,274,155,119,0.5656934306569343,0.4343065693430657
1514,38,2,390,253,137,0.6487179487179487,0.35128205128205126
1515,38,3,310,191,119,0.6161290322580645,0.38387096774193546
1516,38,4,327,203,124,0.6207951070336392,0.37920489296636084
1517,38,5,320,181,139,0.565625,0.434375
1518,38,6,304,163,141,0.5361842105263158,0.46381578947368424
1519,38,7,327,213,114,0.6513761467889908,0.3486238532110092
1520,38,8,287,171,116,0.5958188153310104,0.40418118466898956
1521,38,9,348,202,146,0.5804597701149425,0.41954022988505746
1522,38,10,255,134,121,0.5254901960784314,0.4745098039215686
1523,38,11,288,169,119,0.5868055555555556,0.4131944444444444
1524,38,12,326,221,105,0.6779141104294478,0.3220858895705521
1525,38,13,339,187,152,0.551622418879056,0.44837758112094395
1526,38,14,320,185,135,0.578125,0.421875
1527,38,15,273,163,110,0.5970695970695971,0.40293040293040294
1528,38,16,334,201,133,0.6017964071856288,0.39820359281437123
1529,38,17,338,194,144,0.5739644970414202,0.4260355029585799
1530,38,18,329,220,109,0.668693009118541,0.331306990881459
1531,38,19,375,285,90,0.76,0.24
1532,38,20,297,186,111,0.6262626262626263,0.37373737373737376
1533,38,21,238,136,102,0.5714285714285714,0.42857142857142855
1534,38,22,294,174,120,0.5918367346938775,0.40816326530612246
1535,38,23,336,203,133,0.6041666666666666,0.3958333333333333
1536,38,24,375,239,136,0.6373333333333333,0.3626666666666667
1537,38,25,244,149,95,0.610655737704918,0.38934426229508196
1538,38,26,342,229,113,0.6695906432748538,0.3304093567251462
1539,38,27,318,200,118,0.6289308176100629,0.3710691823899371
1540,38,28,377,239,138,0.6339522546419099,0.3660477453580902
1541,38,29,295,170,125,0.576271186440678,0.423728813559322
1542,38,30,297,174,123,0.5858585858585859,0.41414141414141414
1543,38,31,302,162,140,0.5364238410596026,0.46357615894039733
1544,38,32,277,166,111,0.5992779783393501,0.4007220216606498
1545,38,33,285,147,138,0.5157894736842106,0.4842105263157895
1546,38,34,277,152,125,0.5487364620938628,0.45126353790613716
1547,38,35,292,155,137,0.5308219178082192,0.4691780821917808
1548,38,36,267,168,99,0.6292134831460674,0.3707865168539326
1549,38,37,325,156,169,0.48,0.52
1550,38,38,257,154,103,0.5992217898832685,0.40077821011673154
1551,38,39,353,197,156,0.5580736543909348,0.44192634560906513
1552,38,40,307,197,110,0.6416938110749185,0.3583061889250814
1553,38,41,319,204,115,0.6394984326018809,0.3605015673981191
1554,39,1,306,196,110,0.6405228758169934,0.35947712418300654
1555,39,2,405,284,121,0.7012345679012346,0.29876543209876544
1556,39,3,317,194,123,0.61198738170347,0.38801261829652994
1557,39,4,319,203,116,0.6363636363636364,0.36363636363636365
1558,39,5,312,161,151,0.5160256410256411,0.483974358974359
1559,39,6,287,134,153,0.46689895470383275,0.5331010452961672
1560,39,7,273,128,145,0.46886446886446886,0.5311355311355311
1561,39,8,334,133,201,0.39820359281437123,0.6017964071856288
1562,39,9,302,180,122,0.5960264900662252,0.40397350993377484
1563,39,10,150,77,73,0.5133333333333333,0.4866666666666667
1564,39,11,271,158,113,0.5830258302583026,0.41697416974169743
1565,39,12,339,161,178,0.4749262536873156,0.5250737463126843
1566,39,13,279,162,117,0.5806451612903226,0.41935483870967744
1567,39,14,255,152,103,0.596078431372549,0.403921568627451
1568,39,15,356,250,106,0.702247191011236,0.29775280898876405
1569,39,16,223,94,129,0.42152466367713004,0.57847533632287
1570,39,17,341,191,150,0.5601173020527859,0.4398826979472141
1571,39,18,306,155,151,0.5065359477124183,0.4934640522875817
1572,39,19,307,166,141,0.5407166123778502,0.4592833876221498
1573,39,20,368,244,124,0.6630434782608695,0.33695652173913043
1574,39,21,300,193,107,0.6433333333333333,0.3566666666666667
1575,39,22,229,95,134,0.4148471615720524,0.5851528384279476
1576,39,23,378,243,135,0.6428571428571429,0.35714285714285715
1577,39,24,417,251,166,0.6019184652278178,0.3980815347721823
1578,39,25,226,114,112,0.504424778761062,0.49557522123893805
1579,39,26,317,188,129,0.5930599369085173,0.4069400630914827
1580,39,27,72,48,24,0.6666666666666666,0.3333333333333333
1581,39,28,357,193,164,0.5406162464985994,0.45938375350140054
1582,39,29,136,76,60,0.5588235294117647,0.4411764705882353
1583,39,30,328,151,177,0.4603658536585366,0.5396341463414634
1584,39,31,250,117,133,0.468,0.532
1585,39,32,308,182,126,0.5909090909090909,0.4090909090909091
1586,39,33,307,177,130,0.5765472312703583,0.4234527687296417
1587,39,34,288,164,124,0.5694444444444444,0.4305555555555556
1588,39,35,305,136,169,0.4459016393442623,0.5540983606557377
1589,39,36,121,83,38,0.6859504132231405,0.3140495867768595
1590,39,37,351,247,104,0.7037037037037037,0.2962962962962963
1591,39,38,211,155,56,0.7345971563981043,0.26540284360189575
1592,39,39,199,109,90,0.5477386934673367,0.45226130653266333
1593,39,40,269,170,99,0.6319702602230484,0.3680297397769517
1594,39,41,372,243,129,0.6532258064516129,0.3467741935483871
1595,39,42,359,250,109,0.6963788300835655,0.30362116991643456
1596,39,43,376,240,136,0.6382978723404256,0.3617021276595745
1597,39,44,259,187,72,0.722007722007722,0.277992277992278
1598,39,45,348,236,112,0.6781609195402298,0.3218390804597701
1599,40,1,265,146,119,0.5509433962264151,0.4490566037735849
1600,40,2,284,143,141,0.5035211267605634,0.4964788732394366
1601,40,3,353,187,166,0.5297450424929179,0.4702549575070821
1602,40,4,229,127,102,0.5545851528384279,0.44541484716157204
1603,40,5,329,182,147,0.5531914893617021,0.44680851063829785
1604,40,6,349,148,201,0.42406876790830944,0.5759312320916905
1605,40,7,342,192,150,0.5614035087719298,0.43859649122807015
1606,40,8,365,179,186,0.4904109589041096,0.5095890410958904
1607,40,9,257,161,96,0.6264591439688716,0.3735408560311284
1608,40,10,336,173,163,0.5148809523809523,0.4851190476190476
1609,40,11,341,195,146,0.5718475073313783,0.4281524926686217
1610,40,12,213,128,85,0.6009389671361502,0.39906103286384975
1611,40,13,395,178,217,0.4506329113924051,0.549367088607595
1612,40,14,255,145,110,0.5686274509803921,0.43137254901960786
1613,40,15,274,155,119,0.5656934306569343,0.4343065693430657
1614,40,16,351,190,161,0.5413105413105413,0.4586894586894587
1615,40,17,297,167,130,0.5622895622895623,0.4377104377104377
1616,40,18,231,99,132,0.42857142857142855,0.5714285714285714
1617,40,19,396,213,183,0.5378787878787878,0.4621212121212121
1618,40,20,276,159,117,0.5760869565217391,0.42391304347826086
1619,40,21,357,202,155,0.5658263305322129,0.4341736694677871
1620,40,22,281,147,134,0.5231316725978647,0.47686832740213525
1621,40,23,380,197,183,0.5184210526315789,0.48157894736842105
1622,40,24,263,142,121,0.5399239543726235,0.4600760456273764
1623,40,25,346,202,144,0.5838150289017341,0.4161849710982659
1624,40,26,346,179,167,0.5173410404624278,0.48265895953757226
1625,40,27,402,184,218,0.4577114427860697,0.5422885572139303
1626,40,28,328,147,181,0.4481707317073171,0.551829268292683
1627,40,29,356,226,130,0.6348314606741573,0.3651685393258427
1628,40,30,365,253,112,0.6931506849315069,0.30684931506849317
1629,40,31,358,177,181,0.49441340782122906,0.505586592178771
1630,40,32,365,197,168,0.5397260273972603,0.4602739726027397
1631,40,33,333,168,165,0.5045045045045045,0.4954954954954955
1632,40,34,286,161,125,0.5629370629370629,0.4370629370629371
1633,40,35,210,119,91,0.5666666666666667,0.43333333333333335
1634,40,36,307,183,124,0.5960912052117264,0.40390879478827363
1635,40,37,324,155,169,0.4783950617283951,0.5216049382716049
1636,40,38,376,180,196,0.4787234042553192,0.5212765957446809
1637,40,39,95,42,53,0.4421052631578947,0.5578947368421052
1638,41,1,384,234,150,0.609375,0.390625
1639,41,2,442,285,157,0.6447963800904978,0.3552036199095023
1640,41,3,340,193,147,0.5676470588235294,0.4323529411764706
1641,41,4,478,308,170,0.6443514644351465,0.35564853556485354
1642,41,5,428,275,153,0.6425233644859814,0.3574766355140187
1643,41,6,500,372,128,0.744,0.256
1644,41,7,470,326,144,0.6936170212765957,0.30638297872340425
1645,41,8,425,255,170,0.6,0.4
1646,41,9,391,220,171,0.5626598465473146,0.4373401534526854
1647,41,10,467,320,147,0.6852248394004282,0.3147751605995717
1648,41,11,445,271,174,0.6089887640449438,0.39101123595505616
1649,41,12,387,238,149,0.6149870801033591,0.3850129198966408
1650,41,13,444,266,178,0.5990990990990991,0.4009009009009009
1651,41,14,477,352,125,0.7379454926624738,0.2620545073375262
1652,41,15,477,298,179,0.6247379454926625,0.3752620545073375
1653,41,16,373,223,150,0.5978552278820375,0.40214477211796246
1654,41,17,415,284,131,0.6843373493975904,0.3156626506024096
1655,41,18,374,232,142,0.6203208556149733,0.37967914438502676
1656,41,19,438,290,148,0.6621004566210046,0.3378995433789954
1657,41,20,329,218,111,0.662613981762918,0.3373860182370821
1658,41,21,390,276,114,0.7076923076923077,0.2923076923076923
1659,41,22,426,253,173,0.5938967136150235,0.4061032863849765
1660,41,23,420,281,139,0.669047619047619,0.33095238095238094
1661,41,24,369,228,141,0.6178861788617886,0.3821138211382114
1662,41,25,203,117,86,0.5763546798029556,0.4236453201970443
1663,41,26,425,255,170,0.6,0.4
1664,41,27,276,184,92,0.6666666666666666,0.3333333333333333
1665,41,28,263,152,111,0.5779467680608364,0.4220532319391635
1666,41,29,214,150,64,0.7009345794392523,0.29906542056074764
1667,41,30,402,236,166,0.5870646766169154,0.4129353233830846
1668,41,31,456,325,131,0.7127192982456141,0.28728070175438597
1669,41,32,314,199,115,0.6337579617834395,0.3662420382165605
1670,41,33,354,213,141,0.6016949152542372,0.3983050847457627
1671,41,34,353,231,122,0.6543909348441926,0.34560906515580736
1672,41,35,457,285,172,0.6236323851203501,0.37636761487964987
1673,41,36,396,242,154,0.6111111111111112,0.3888888888888889
1674,41,37,438,273,165,0.6232876712328768,0.3767123287671233
1675,41,38,349,195,154,0.5587392550143266,0.44126074498567336
1676,41,39,416,275,141,0.6610576923076923,0.3389423076923077
1677,41,40,466,299,167,0.6416309012875536,0.3583690987124464
1678,41,41,428,282,146,0.6588785046728972,0.3411214953271028
1679,41,42,419,269,150,0.6420047732696897,0.35799522673031026
1680,41,43,413,269,144,0.6513317191283293,0.3486682808716707
1681,41,44,455,321,134,0.7054945054945055,0.2945054945054945
1682,41,45,343,200,143,0.5830903790087464,0.41690962099125367
1683,41,46,446,282,164,0.6322869955156951,0.36771300448430494
1684,41,47,398,255,143,0.6407035175879398,0.3592964824120603
1685,42,1,419,383,36,0.9140811455847255,0.08591885441527446
1686,42,2,262,202,60,0.7709923664122137,0.22900763358778625
1687,42,3,256,199,57,0.77734375,0.22265625
1688,42,4,463,388,75,0.838012958963283,0.16198704103671707
1689,42,5,251,235,16,0.9362549800796812,0.06374501992031872
1690,42,6,447,341,106,0.7628635346756152,0.2371364653243848
1691,42,7,436,385,51,0.8830275229357798,0.11697247706422019
1692,42,8,347,289,58,0.8328530259365994,0.16714697406340057
1693,42,9,315,245,70,0.7777777777777778,0.2222222222222222
1694,42,10,287,242,45,0.8432055749128919,0.156794425087108
1695,42,11,283,226,57,0.7985865724381626,0.20141342756183744
1696,42,12,312,271,41,0.8685897435897436,0.13141025641025642
1697,42,13,430,338,92,0.786046511627907,0.21395348837209302
1698,42,14,298,268,30,0.8993288590604027,0.10067114093959731
1699,42,15,234,209,25,0.8931623931623932,0.10683760683760683
1700,42,16,303,238,65,0.7854785478547854,0.2145214521452145
1701,42,17,329,300,29,0.9118541033434651,0.08814589665653495
1702,42,18,248,210,38,0.8467741935483871,0.1532258064516129
1703,42,19,433,393,40,0.9076212471131639,0.09237875288683603
1704,42,20,239,209,30,0.8744769874476988,0.12552301255230125
1705,42,21,247,194,53,0.7854251012145749,0.2145748987854251
1706,42,22,181,167,14,0.9226519337016574,0.07734806629834254
1707,42,23,310,280,30,0.9032258064516129,0.0967741935483871
1708,42,24,371,318,53,0.8571428571428571,0.14285714285714285
1709,42,25,345,289,56,0.8376811594202899,0.16231884057971013
1710,42,26,348,300,48,0.8620689655172413,0.13793103448275862
1711,42,27,294,220,74,0.7482993197278912,0.25170068027210885
1712,42,28,424,333,91,0.785377358490566,0.21462264150943397
1713,42,29,301,265,36,0.8803986710963455,0.11960132890365449
1714,42,30,369,328,41,0.8888888888888888,0.1111111111111111
1715,42,31,329,293,36,0.8905775075987842,0.1094224924012158
1716,42,32,255,227,28,0.8901960784313725,0.10980392156862745
1717,42,33,312,245,67,0.7852564102564102,0.21474358974358973
1718,42,34,401,369,32,0.9201995012468828,0.0798004987531172
1719,42,35,421,347,74,0.8242280285035629,0.17577197149643706
1720,42,36,338,285,53,0.8431952662721893,0.15680473372781065
1721,42,37,200,185,15,0.925,0.075
1722,42,38,295,264,31,0.8949152542372881,0.10508474576271186
1723,42,39,260,226,34,0.8692307692307693,0.13076923076923078
1724,42,40,320,280,40,0.875,0.125
1725,42,41,286,228,58,0.7972027972027972,0.20279720279720279
1726,42,42,346,290,56,0.838150289017341,0.16184971098265896
1727,43,1,215,166,49,0.772093023255814,0.22790697674418606
1728,43,2,349,301,48,0.8624641833810889,0.13753581661891118
1729,43,3,411,365,46,0.8880778588807786,0.11192214111922141
1730,43,4,345,310,35,0.8985507246376812,0.10144927536231885
1731,43,5,269,238,31,0.8847583643122676,0.11524163568773234
1732,43,6,253,204,49,0.8063241106719368,0.19367588932806323
1733,43,7,258,208,50,0.8062015503875969,0.1937984496124031
1734,43,8,296,241,55,0.8141891891891891,0.1858108108108108
1735,43,9,434,355,79,0.8179723502304147,0.18202764976958524
1736,43,10,406,348,58,0.8571428571428571,0.14285714285714285
1737,43,11,287,245,42,0.8536585365853658,0.14634146341463414
1738,43,12,220,187,33,0.85,0.15
1739,43,13,317,241,76,0.7602523659305994,0.23974763406940064
1740,43,14,403,364,39,0.9032258064516129,0.0967741935483871
1741,43,15,341,280,61,0.8211143695014663,0.17888563049853373
1742,43,16,321,264,57,0.822429906542056,0.17757009345794392
1743,43,17,289,255,34,0.8823529411764706,0.11764705882352941
1744,43,18,382,329,53,0.8612565445026178,0.1387434554973822
1745,43,19,385,316,69,0.8207792207792208,0.17922077922077922
1746,43,20,393,307,86,0.7811704834605598,0.21882951653944022
1747,43,21,382,296,86,0.774869109947644,0.225130890052356
1748,43,22,205,157,48,0.7658536585365854,0.23414634146341465
1749,43,23,186,151,35,0.8118279569892473,0.1881720430107527
1750,43,24,246,203,43,0.8252032520325203,0.17479674796747968
1751,43,25,307,252,55,0.8208469055374593,0.1791530944625407
1752,43,26,285,248,37,0.8701754385964913,0.12982456140350876
1753,43,27,337,286,51,0.8486646884272997,0.1513353115727003
1754,43,28,428,374,54,0.8738317757009346,0.1261682242990654
1755,43,29,321,244,77,0.7601246105919003,0.2398753894080997
1756,43,30,354,286,68,0.807909604519774,0.192090395480226
1757,43,31,391,307,84,0.7851662404092071,0.21483375959079284
1758,43,32,353,298,55,0.8441926345609065,0.1558073654390935
1759,43,33,429,389,40,0.9067599067599068,0.09324009324009325
1760,43,34,276,224,52,0.8115942028985508,0.18840579710144928
1761,43,35,447,399,48,0.8926174496644296,0.10738255033557047
1762,43,36,120,74,46,0.6166666666666667,0.38333333333333336
1763,43,37,284,231,53,0.8133802816901409,0.18661971830985916
1764,43,38,399,373,26,0.9348370927318296,0.06516290726817042
1765,43,39,272,196,76,0.7205882352941176,0.27941176470588236
1766,43,40,194,134,60,0.6907216494845361,0.30927835051546393
1767,43,41,459,379,80,0.8257080610021786,0.17429193899782136
1768,43,42,312,248,64,0.7948717948717948,0.20512820512820512
1769,43,43,461,409,52,0.8872017353579176,0.11279826464208242
1770,43,44,337,288,49,0.8545994065281899,0.14540059347181009
1771,43,45,250,212,38,0.848,0.152
1772,43,46,180,153,27,0.85,0.15
1773,44,1,524,388,136,0.7404580152671756,0.2595419847328244
1774,44,2,317,251,66,0.7917981072555205,0.2082018927444795
1775,44,3,320,269,51,0.840625,0.159375
1776,44,4,410,334,76,0.8146341463414634,0.18536585365853658
1777,44,5,278,185,93,0.6654676258992805,0.3345323741007194
1778,44,6,311,247,64,0.7942122186495176,0.2057877813504823
1779,44,7,306,256,50,0.8366013071895425,0.16339869281045752
1780,44,8,361,262,99,0.7257617728531855,0.2742382271468144
1781,44,9,272,213,59,0.7830882352941176,0.21691176470588236
1782,44,10,279,226,53,0.8100358422939068,0.18996415770609318
1783,44,11,301,232,69,0.770764119601329,0.2292358803986711
1784,44,12,372,281,91,0.7553763440860215,0.2446236559139785
1785,44,13,246,212,34,0.8617886178861789,0.13821138211382114
1786,44,14,268,216,52,0.8059701492537313,0.19402985074626866
1787,44,15,334,246,88,0.7365269461077845,0.2634730538922156
1788,44,16,336,257,79,0.7648809523809523,0.23511904761904762
1789,44,17,411,314,97,0.7639902676399026,0.2360097323600973
1790,44,18,314,245,69,0.7802547770700637,0.2197452229299363
1791,44,19,401,289,112,0.7206982543640897,0.2793017456359102
1792,44,20,216,140,76,0.6481481481481481,0.35185185185185186
1793,44,21,298,232,66,0.7785234899328859,0.2214765100671141
1794,44,22,371,287,84,0.7735849056603774,0.22641509433962265
1795,44,23,284,213,71,0.75,0.25
1796,44,24,323,243,80,0.7523219814241486,0.2476780185758514
1797,44,25,296,230,66,0.777027027027027,0.22297297297297297
1798,44,26,280,202,78,0.7214285714285714,0.2785714285714286
1799,44,27,358,273,85,0.7625698324022346,0.23743016759776536
1800,44,28,320,228,92,0.7125,0.2875
1801,44,29,304,225,79,0.7401315789473685,0.2598684210526316
1802,44,30,325,241,84,0.7415384615384616,0.25846153846153846
1803,44,31,243,188,55,0.7736625514403292,0.22633744855967078
1804,44,32,330,244,86,0.7393939393939394,0.2606060606060606
1805,44,33,255,176,79,0.6901960784313725,0.30980392156862746
1806,44,34,364,268,96,0.7362637362637363,0.26373626373626374
1807,44,35,444,355,89,0.7995495495495496,0.20045045045045046
1808,44,36,286,222,64,0.7762237762237763,0.22377622377622378
1809,44,37,339,244,95,0.7197640117994101,0.28023598820059
1810,44,38,268,212,56,0.7910447761194029,0.208955223880597
1811,44,39,278,229,49,0.8237410071942446,0.17625899280575538
1812,44,40,300,230,70,0.7666666666666667,0.23333333333333334
1813,44,41,340,258,82,0.7588235294117647,0.2411764705882353
1814,45,1,261,140,121,0.5363984674329502,0.46360153256704983
1815,45,2,283,151,132,0.5335689045936396,0.4664310954063604
1816,45,3,294,176,118,0.5986394557823129,0.4013605442176871
1817,45,4,408,229,179,0.5612745098039216,0.4387254901960784
1818,45,5,378,236,142,0.6243386243386243,0.37566137566137564
1819,45,6,445,281,164,0.6314606741573033,0.3685393258426966
1820,45,7,484,281,203,0.5805785123966942,0.4194214876033058
1821,45,8,328,164,164,0.5,0.5
1822,45,9,330,169,161,0.5121212121212121,0.48787878787878786
1823,45,10,389,188,201,0.4832904884318766,0.5167095115681234
1824,45,11,258,117,141,0.45348837209302323,0.5465116279069767
1825,45,12,320,164,156,0.5125,0.4875
1826,45,13,351,193,158,0.5498575498575499,0.45014245014245013
1827,45,14,424,262,162,0.6179245283018868,0.38207547169811323
1828,45,15,470,268,202,0.5702127659574469,0.4297872340425532
1829,45,16,318,194,124,0.610062893081761,0.389937106918239
1830,45,17,376,235,141,0.625,0.375
1831,45,18,356,209,147,0.5870786516853933,0.41292134831460675
1832,45,19,174,112,62,0.6436781609195402,0.3563218390804598
1833,45,20,221,126,95,0.5701357466063348,0.4298642533936652
1834,45,21,333,206,127,0.6186186186186187,0.3813813813813814
1835,45,22,324,201,123,0.6203703703703703,0.37962962962962965
1836,45,23,360,223,137,0.6194444444444445,0.38055555555555554
1837,45,24,325,192,133,0.5907692307692308,0.40923076923076923
1838,45,25,285,173,112,0.6070175438596491,0.3929824561403509
1839,45,26,191,113,78,0.5916230366492147,0.4083769633507853
1840,45,27,315,187,128,0.5936507936507937,0.40634920634920635
1841,45,28,274,167,107,0.6094890510948905,0.3905109489051095
1842,45,29,226,141,85,0.6238938053097345,0.37610619469026546
1843,45,30,305,183,122,0.6,0.4
1844,45,31,289,182,107,0.629757785467128,0.370242214532872
1845,45,32,321,187,134,0.5825545171339563,0.4174454828660436
1846,45,33,236,150,86,0.635593220338983,0.3644067796610169
1847,45,34,369,220,149,0.5962059620596206,0.4037940379403794
1848,45,35,422,257,165,0.6090047393364929,0.3909952606635071
1849,45,36,400,240,160,0.6,0.4
1850,45,37,325,201,124,0.6184615384615385,0.38153846153846155
1851,45,38,288,173,115,0.6006944444444444,0.3993055555555556
1852,45,39,324,197,127,0.6080246913580247,0.39197530864197533
1853,45,40,363,238,125,0.6556473829201102,0.3443526170798898
1854,45,41,339,207,132,0.6106194690265486,0.3893805309734513
1855,45,42,399,254,145,0.6365914786967418,0.3634085213032581
1856,45,43,427,250,177,0.585480093676815,0.41451990632318503
1857,45,44,378,245,133,0.6481481481481481,0.35185185185185186
1858,45,45,243,140,103,0.5761316872427984,0.42386831275720166
1859,45,46,263,158,105,0.6007604562737643,0.39923954372623577
1860,45,47,284,164,120,0.5774647887323944,0.4225352112676056
1861,45,48,292,197,95,0.6746575342465754,0.3253424657534247
1862,46,1,311,174,137,0.5594855305466238,0.4405144694533762
1863,46,2,329,207,122,0.6291793313069909,0.3708206686930091
1864,46,3,457,353,104,0.7724288840262582,0.2275711159737418
1865,46,4,367,235,132,0.6403269754768393,0.35967302452316074
1866,46,5,297,221,76,0.7441077441077442,0.2558922558922559
1867,46,6,315,184,131,0.5841269841269842,0.4158730158730159
1868,46,7,492,352,140,0.7154471544715447,0.2845528455284553
1869,46,8,282,149,133,0.5283687943262412,0.4716312056737589
1870,46,9,324,218,106,0.6728395061728395,0.3271604938271605
1871,46,10,329,233,96,0.7082066869300911,0.2917933130699088
1872,46,11,322,218,104,0.6770186335403726,0.32298136645962733
1873,46,12,318,177,141,0.5566037735849056,0.44339622641509435
1874,46,13,317,218,99,0.6876971608832808,0.31230283911671924
1875,46,14,428,217,211,0.5070093457943925,0.4929906542056075
1876,46,15,347,252,95,0.7262247838616714,0.2737752161383285
1877,46,16,357,201,156,0.5630252100840336,0.4369747899159664
1878,46,17,432,310,122,0.7175925925925926,0.2824074074074074
1879,46,18,311,219,92,0.7041800643086816,0.2958199356913183
1880,46,19,263,198,65,0.752851711026616,0.24714828897338403
1881,46,20,351,200,151,0.5698005698005698,0.4301994301994302
1882,46,21,226,135,91,0.5973451327433629,0.4026548672566372
1883,46,22,289,115,174,0.39792387543252594,0.6020761245674741
1884,46,23,284,175,109,0.6161971830985915,0.38380281690140844
1885,46,24,376,283,93,0.7526595744680851,0.2473404255319149
1886,46,25,350,185,165,0.5285714285714286,0.4714285714285714
1887,46,26,280,166,114,0.5928571428571429,0.40714285714285714
1888,46,27,329,213,116,0.6474164133738601,0.3525835866261398
1889,46,28,421,309,112,0.7339667458432304,0.2660332541567696
1890,46,29,304,208,96,0.6842105263157895,0.3157894736842105
1891,46,30,334,191,143,0.5718562874251497,0.4281437125748503
1892,46,31,292,197,95,0.6746575342465754,0.3253424657534247
1893,46,32,416,214,202,0.5144230769230769,0.4855769230769231
1894,46,33,358,283,75,0.7905027932960894,0.20949720670391062
1895,46,34,346,221,125,0.638728323699422,0.36127167630057805
1896,46,35,410,266,144,0.6487804878048781,0.35121951219512193
1897,46,36,364,273,91,0.75,0.25
1898,46,37,247,159,88,0.6437246963562753,0.3562753036437247
1899,46,38,299,180,119,0.6020066889632107,0.3979933110367893
1900,46,39,316,249,67,0.7879746835443038,0.2120253164556962
1901,46,40,297,165,132,0.5555555555555556,0.4444444444444444
1902,47,1,191,133,58,0.6963350785340314,0.3036649214659686
1903,47,2,418,290,128,0.69377990430622,0.3062200956937799
1904,47,3,460,352,108,0.7652173913043478,0.23478260869565218
1905,47,4,398,272,126,0.6834170854271356,0.3165829145728643
1906,47,5,340,222,118,0.6529411764705882,0.34705882352941175
1907,47,6,326,237,89,0.7269938650306749,0.27300613496932513
1908,47,7,304,183,121,0.6019736842105263,0.3980263157894737
1909,47,8,400,291,109,0.7275,0.2725
1910,47,9,260,160,100,0.6153846153846154,0.38461538461538464
1911,47,10,336,190,146,0.5654761904761905,0.43452380952380953
1912,47,11,276,210,66,0.7608695652173914,0.2391304347826087
1913,47,12,360,221,139,0.6138888888888889,0.3861111111111111
1914,47,13,328,178,150,0.5426829268292683,0.4573170731707317
1915,47,14,321,218,103,0.6791277258566978,0.32087227414330216
1916,47,15,350,142,208,0.4057142857142857,0.5942857142857143
1917,47,16,383,235,148,0.6135770234986945,0.38642297650130547
1918,47,17,317,201,116,0.6340694006309149,0.3659305993690852
1919,47,18,345,251,94,0.7275362318840579,0.27246376811594203
1920,47,19,357,185,172,0.5182072829131653,0.48179271708683474
1921,47,20,355,202,153,0.5690140845070423,0.4309859154929577
1922,47,21,301,181,120,0.6013289036544851,0.39867109634551495
1923,47,22,386,229,157,0.5932642487046632,0.4067357512953368
1924,47,23,357,179,178,0.5014005602240896,0.49859943977591037
1925,47,24,307,204,103,0.6644951140065146,0.3355048859934853
1926,47,25,345,222,123,0.6434782608695652,0.3565217391304348
1927,47,26,360,193,167,0.5361111111111111,0.4638888888888889
1928,47,27,282,184,98,0.6524822695035462,0.3475177304964539
1929,47,28,351,217,134,0.6182336182336182,0.3817663817663818
1930,47,29,333,223,110,0.6696696696696697,0.3303303303303303
1931,47,30,351,202,149,0.5754985754985755,0.42450142450142453
1932,47,31,317,161,156,0.5078864353312302,0.4921135646687697
1933,47,32,357,199,158,0.5574229691876751,0.4425770308123249
1934,47,33,343,272,71,0.793002915451895,0.20699708454810495
1935,47,34,403,253,150,0.6277915632754343,0.37220843672456577
1936,47,35,318,221,97,0.6949685534591195,0.3050314465408805
1937,47,36,359,207,152,0.5766016713091922,0.4233983286908078
1938,47,37,361,223,138,0.6177285318559557,0.38227146814404434
1939,47,38,318,201,117,0.6320754716981132,0.36792452830188677
1940,47,39,370,252,118,0.6810810810810811,0.31891891891891894
1941,47,40,372,229,143,0.6155913978494624,0.3844086021505376
1942,47,41,401,246,155,0.6134663341645885,0.3865336658354115
1943,47,42,289,133,156,0.4602076124567474,0.5397923875432526
1944,47,43,305,213,92,0.6983606557377049,0.3016393442622951
1945,47,44,355,267,88,0.752112676056338,0.24788732394366197
1946,47,45,359,215,144,0.5988857938718662,0.4011142061281337
1947,47,46,329,197,132,0.5987841945288754,0.4012158054711246
1948,47,47,344,231,113,0.6715116279069767,0.32848837209302323
1949,47,48,51,42,9,0.8235294117647058,0.17647058823529413
1950,48,1,300,149,151,0.49666666666666665,0.5033333333333333
1951,48,2,203,142,61,0.6995073891625616,0.30049261083743845
1952,48,3,328,179,149,0.5457317073170732,0.45426829268292684
1953,48,4,301,187,114,0.6212624584717608,0.3787375415282392
1954,48,5,250,160,90,0.64,0.36
1955,48,6,348,215,133,0.617816091954023,0.382183908045977
1956,48,7,333,184,149,0.5525525525525525,0.44744744744744747
1957,48,8,276,184,92,0.6666666666666666,0.3333333333333333
1958,48,9,275,187,88,0.68,0.32
1959,48,10,427,225,202,0.5269320843091335,0.47306791569086654
1960,48,11,303,179,124,0.5907590759075908,0.40924092409240925
1961,48,12,371,229,142,0.6172506738544474,0.38274932614555257
1962,48,13,470,313,157,0.6659574468085107,0.33404255319148934
1963,48,14,228,160,68,0.7017543859649122,0.2982456140350877
1964,48,15,207,128,79,0.6183574879227053,0.38164251207729466
1965,48,16,302,156,146,0.5165562913907285,0.48344370860927155
1966,48,17,326,188,138,0.5766871165644172,0.4233128834355828
1967,48,18,314,213,101,0.678343949044586,0.321656050955414
1968,48,19,260,156,104,0.6,0.4
1969,48,20,369,175,194,0.4742547425474255,0.5257452574525745
1970,48,21,378,219,159,0.5793650793650794,0.42063492063492064
1971,48,22,372,253,119,0.6801075268817204,0.31989247311827956
1972,48,23,461,280,181,0.6073752711496746,0.3926247288503254
1973,48,24,345,205,140,0.5942028985507246,0.4057971014492754
1974,48,25,345,201,144,0.5826086956521739,0.41739130434782606
1975,48,26,184,112,72,0.6086956521739131,0.391304347826087
1976,48,27,276,151,125,0.5471014492753623,0.4528985507246377
1977,48,28,423,293,130,0.6926713947990544,0.3073286052009456
1978,48,29,233,184,49,0.7896995708154506,0.21030042918454936
1979,48,30,292,153,139,0.523972602739726,0.476027397260274
1980,48,31,359,183,176,0.5097493036211699,0.49025069637883006
1981,48,32,258,125,133,0.4844961240310077,0.5155038759689923
1982,48,33,253,194,59,0.766798418972332,0.233201581027668
1983,48,34,308,162,146,0.525974025974026,0.474025974025974
1984,48,35,274,184,90,0.6715328467153284,0.3284671532846715
1985,48,36,265,180,85,0.6792452830188679,0.32075471698113206
1986,48,37,306,137,169,0.4477124183006536,0.5522875816993464
1987,48,38,390,250,140,0.6410256410256411,0.358974358974359
1988,48,39,317,205,112,0.6466876971608833,0.35331230283911674
1989,48,40,287,143,144,0.49825783972125437,0.5017421602787456
1990,48,41,296,150,146,0.5067567567567568,0.49324324324324326
1991,48,42,327,160,167,0.4892966360856269,0.5107033639143731
1992,48,43,357,209,148,0.5854341736694678,0.41456582633053224
1993,48,44,366,197,169,0.5382513661202186,0.46174863387978143
1994,48,45,220,111,109,0.5045454545454545,0.4954545454545455
1995,48,46,243,153,90,0.6296296296296297,0.37037037037037035
1996,49,1,189,102,87,0.5396825396825397,0.4603174603174603
1997,49,2,220,111,109,0.5045454545454545,0.4954545454545455
1998,49,3,361,168,193,0.46537396121883656,0.5346260387811634
1999,49,4,355,147,208,0.4140845070422535,0.5859154929577465
2000,49,5,368,203,165,0.5516304347826086,0.4483695652173913
2001,49,6,264,122,142,0.4621212121212121,0.5378787878787878
2002,49,7,288,148,140,0.5138888888888888,0.4861111111111111
2003,49,8,266,143,123,0.5375939849624061,0.462406015037594
2004,49,9,311,147,164,0.47266881028938906,0.5273311897106109
2005,49,10,347,153,194,0.4409221902017291,0.5590778097982709
2006,49,11,380,175,205,0.4605263157894737,0.5394736842105263
2007,49,12,398,177,221,0.44472361809045224,0.5552763819095478
2008,49,13,405,194,211,0.47901234567901235,0.5209876543209877
2009,49,14,306,177,129,0.5784313725490197,0.4215686274509804
2010,49,15,228,107,121,0.4692982456140351,0.5307017543859649
2011,49,16,350,204,146,0.5828571428571429,0.41714285714285715
2012,49,17,277,153,124,0.5523465703971119,0.44765342960288806
2013,49,18,420,178,242,0.4238095238095238,0.5761904761904761
2014,49,19,272,134,138,0.49264705882352944,0.5073529411764706
2015,49,20,456,200,256,0.43859649122807015,0.5614035087719298
2016,49,21,225,125,100,0.5555555555555556,0.4444444444444444
2017,49,22,368,168,200,0.45652173913043476,0.5434782608695652
2018,49,23,324,131,193,0.404320987654321,0.595679012345679
2019,49,24,252,132,120,0.5238095238095238,0.47619047619047616
2020,49,25,376,174,202,0.4627659574468085,0.5372340425531915
2021,49,26,384,193,191,0.5026041666666666,0.4973958333333333
2022,49,27,335,141,194,0.4208955223880597,0.5791044776119403
2023,49,28,338,149,189,0.4408284023668639,0.5591715976331361
2024,49,29,352,152,200,0.4318181818181818,0.5681818181818182
2025,49,30,322,154,168,0.4782608695652174,0.5217391304347826
2026,49,31,256,160,96,0.625,0.375
2027,49,32,325,180,145,0.5538461538461539,0.4461538461538462
2028,49,33,280,125,155,0.44642857142857145,0.5535714285714286
2029,50,1,323,245,78,0.7585139318885449,0.24148606811145512
2030,50,2,180,117,63,0.65,0.35
2031,50,3,279,194,85,0.6953405017921147,0.3046594982078853
2032,50,4,316,182,134,0.5759493670886076,0.4240506329113924
2033,50,5,264,192,72,0.7272727272727273,0.2727272727272727
2034,50,6,311,172,139,0.5530546623794212,0.44694533762057875
2035,50,7,369,194,175,0.5257452574525745,0.4742547425474255
2036,50,8,263,134,129,0.5095057034220533,0.49049429657794674
2037,50,9,248,132,116,0.532258064516129,0.46774193548387094
2038,50,10,317,220,97,0.694006309148265,0.305993690851735
2039,50,11,252,207,45,0.8214285714285714,0.17857142857142858
2040,50,12,158,134,24,0.8481012658227848,0.1518987341772152
2041,50,13,243,99,144,0.4074074074074074,0.5925925925925926
2042,50,14,106,81,25,0.7641509433962265,0.2358490566037736
2043,50,15,365,204,161,0.5589041095890411,0.4410958904109589
2044,50,16,123,97,26,0.7886178861788617,0.21138211382113822
2045,50,17,226,134,92,0.5929203539823009,0.40707964601769914
2046,50,18,88,82,6,0.9318181818181818,0.06818181818181818
2047,50,19,200,71,129,0.355,0.645
2048,50,20,318,129,189,0.4056603773584906,0.5943396226415094
2049,50,21,234,120,114,0.5128205128205128,0.48717948717948717
2050,50,22,249,169,80,0.678714859437751,0.321285140562249
2051,50,23,241,158,83,0.6556016597510373,0.34439834024896265
2052,50,24,320,246,74,0.76875,0.23125
2053,50,25,320,239,81,0.746875,0.253125
2054,50,26,272,131,141,0.48161764705882354,0.5183823529411765
2055,50,27,88,73,15,0.8295454545454546,0.17045454545454544
2056,50,28,313,154,159,0.49201277955271566,0.5079872204472844
2057,50,29,218,91,127,0.41743119266055045,0.5825688073394495
2058,50,30,209,106,103,0.507177033492823,0.49282296650717705
2059,50,31,286,131,155,0.458041958041958,0.541958041958042
2060,50,32,256,123,133,0.48046875,0.51953125
2061,50,33,282,224,58,0.7943262411347518,0.20567375886524822
2062,50,34,386,235,151,0.6088082901554405,0.3911917098445596
2063,50,35,329,167,162,0.5075987841945289,0.49240121580547114
2064,50,36,281,148,133,0.5266903914590747,0.47330960854092524
2065,50,37,281,159,122,0.5658362989323843,0.43416370106761565
2066,50,38,170,131,39,0.7705882352941177,0.22941176470588234
2067,50,39,209,146,63,0.6985645933014354,0.3014354066985646
2068,50,40,368,278,90,0.7554347826086957,0.24456521739130435
